Hybrid Dogs
Designer Dogs
Boutique Dogs
Mixed Breed Dogs
Cross Breed Dogs

Labradoodle
    A dog that is bred as a cross between a
    Labrador and a poodle.

Afador - (Afghan Hound x Labrador Retriever mix)
Afaird - (Afghan Hound x Briard mix)
Affen Spaniel - (Affenpinscher x Cocker Spaniel mix)
Affen Border Terrier - (Affenpinscher x Border Terrier mix)
Affen Tzu - (Affenpinscher x Shih Tzu mix)
Affenchon - (Affenpinscher x Bichon Frise mix)
Affengriffon - (Affenpinscher x Brussels Griffon mix)
Affenhuahua - (Affenpinscher x Chihuahua mix)
Affenpoo - (Affenpinscher x Poodle mix)
Affenpug - (Affenpinscher x Pug mix)
Affenshire - (Affenpinscher x Yorkshire Terrier mix)
Affenwich - (Affenpinscher x Norwich Terrier mix)
Afghan Bay Retriever - (Afghan x Chesapeake Bay Retriever mix)
Afghan Chon - (Afghan Hound x Bichon Frise mix)
Afghan Collie - (Afghan Hound x Border Collie mix)
Afghan Retriever - (Afghan Hound x Golden Retriever mix)
Afghan Sheepdog - (Afghan Hound x Belgian Shepherd mix)
Afghan Spaniel - (Afghan Hound x Cocker Spaniel mix)
Afollie - (Afghan Hound x Collie mix)
African-American Bull Boerboel - (Boerboel x American Bulldog mix)
Airedale Shepherd - (Airedale Terrier x German Shepherd mix)
Airedoodle - (Airedale Terrier x Poodle mix)
Akbash Pyrenees - (Akbash Dog x Great Pyrenees mix)
Akbash Rottie - (Akbash Dog x Rottweiler mix)
Aki-Poo - (Akita x Poodle mix)
Akita Basset - (Akita x Basset Hound mix)
Akita Bernard - (Akita x Saint Bernard mix)
Akita Chow - (Akita x Chow Chow mix)
Akita Pit - (Akita x Pit Bull Terrier mix)
Akita Shepherd - (Akita x German Shepherd mix)
Akitamatian - (Akita x Dalmatian mix)
Alaskan Goldenmute - (Alaskan Malamute x Golden Retriever mix)
Alaskan Husky Shepherd - (Alaskan Husky x German Shepherd mix)
Alaskan Irish Setsky - (Alaskan Husky x Irish Setter mix)
Alaskan Malador - (Alaskan Malamute x Labrador Retriever mix)
Alaskan Pit Bull - (Alaskan Malamute x Pit Bull Terrier mix)
Alaskan Shepherd - (Alaskan Malamute x German Shepherd Dog mix)
Alaskan Weimsky - (Weimaraner x Alaskan Husky mix)
Alusky - (Alaskan Malamute x Siberian Husky mix)
American Bandogge - (American Bulldog x Mastiff mix)
American Boston Bull Terrier - (American Pit Bull Terrier x Boston Terrier mix)
American Boxer Foxhound - (American Foxhound x Boxer mix)
American Bull-Aussie - (American Bulldog x Australian Shepherd mix)
American Bull Dogue De Bordeaux - (American Bulldog x Dogue De Bordeaux mix)
American Bull-Jack - (American Bulldog x Jack Russell mix)
American Bull Pei - (American Bulldog x Shar Pei mix)
American Bull Staffy - (American Bulldog x American Staffordshire Terrier mix)
American Bullador - (Labrador Retriever x American Bulldog mix)
American Bulldog Shepherd - (American Bulldog x German Shepherd Dog mix)
American Bullhuahua - American Bulldog x Chihuahua mix)
American Bullweiler - (American Bulldog x Rottweiler mix)
American Bull Dane - (American Bulldog x Great Dane mix)
American Bully Staffy Bull Terrier - (American Bulldog x Staffordshire Bull Terrier mix)
American Chow Bulldog - (American Bulldog x Chow Chow mix)
American Eagle Dog - (American Eskimo x Beagle mix)
American Foxeagle - (American Foxhound x Beagle mix)
American Foxy Dane - (American Foxhound x Great Dane mix)
American French Bull Terrier - (American Pit Bull Terrier x French Bulldog mix)
American French Bulldog - (American Bulldog x French Bulldog mix)
American Gointer - (English Pointer x Golden Retriever mix)
American Hairless Min Pin - (American Hairless Terrier x Miniature Pinscher mix)
American Lab Foxhound - (American Foxhound x Labrador Retriever mix)
American Masti-Bull - (American Bulldog x Mastiff mix)
American Neo Bull - (American Bulldog x Neapolitan Mastiff mix)
American Pit Corso - (American Pit Bull Terrier x Cane Corso mix)
American Pugabull - (American Bulldog x Pug mix)
American Rat Pinscher - (American Rat Terrier x Miniature Pinscher mix)
American Staffy Bullmastiff - (American Staffordshire Terrier x Bullmastiff mix)
Amstiff - (American Stafforshire Terrier x Mastiff mix)
Anatolian Pyrenees - (Anatolian Shepherd x Great Pyrenees mix)
Ausahoula - (Australian Shepherd x Louisiana Catahoula Leopard Dog mix)
Ausky - (Australian Cattle Dog x Siberian Husky mix)
Auss-Tzu - (Miniature Australian Shepherd x Shih Tzu mix)
Aussalier - (Australian Shepherd x Cavalier King Charles Spaniel mix)
Aussie Brittany - (Australian Shepherd x Brittany mix)
Aussie-Chi - (Australian Shepherd x Chihuahua mix)
Aussie Collie - (Australian Shepherd x Collie mix)
Aussie-Corgi - (Australian Shepherd or Miniature Australian Shepherd x Pembroke Welch Corgi mix)
Aussie-Flat - (Australian Shepherd x Flat-Coated Retriever mix)
Aussie Jack - (Australian Shepherd x Jack Russell Terrier mix)
Aussie Malamute - (Australian Shepherd x Alaskan Malamute mix)
Aussie Newfie - (Australian Shepherd x Newfoundland mix)
Aussie Pom - (Australian Shepherd or Mini or Toy Australian Shepherd x Pomeranian mix)
Aussie Rottie - (Australian Shepherd x Rottweiler mix)
Aussie Shiba - (Australian Shepherd x Shiba Inu mix)
Aussie Siberian - (Australian Shepherd x Siberian Husky mix)
Aussie Silk Terrier - (Australian Terrier x Silky Terrier mix)
Aussie Springer - (Australian Shepherd x the English Springer Spaniel mix)
Aussie Wheaten - (Australian Shepherd x Soft Coated Wheaten Terrier mix) 
Aussietare - (Australian Shepherd x Bull Terrier mix)
Aussiedoodle - (Australian Shepherd x Poodle mix)
Aussiedor - (Labrador x Australian Shepherd mix)
Aussimo - (Australian Cattle Dog x American Eskimo Dog mix)
Austi-Pap - (Australian Shepherd (Standard, Toy or Miniature) x Papillon mix)
Australian Boxherd - (Australian Shepherd x Boxer mix)
Australian Eskimo - (American Eskimo x Australian Shepherd mix)
Australian Retriever - (Australian Shepherd x Golden Retriever mix)
Austi-Pap - (Miniature Australian Shepherd x Papillon mix)
Australian Yorkshire Terrier - (Australian Terrier x Yorkshire Terrier mix)
Azawakh Borzoi - (Azawakh Hound x Borzoi mix)
A | B | C | D | E | F | G | H | I | J | K | L | M | N | O | P-Q | R | S | T | U-V | W | X-Y-Z
Ba-Shar - (Basset Hound x Shar-Pei mix)
Bagle Hound - (Basset Hound x Beagle mix)
Balonkatese - (Maltese x Russkaya Tsvetnaya Bolonka mix)
Bascottie - (Basset Hound x Scottish Terrier mix)
Baseagle - (Basenji x Beagle mix)
Basenji Pit - (Basenji x American Pit Bull Terrier mix)
Baskimo - (American Eskimo x Basset Hound mix)
Bassador - (Basset Hound x Labrador Retriever mix)
Basschshund - (Basset Hound x Dachshund mix)
Basselier - (Cavalier King Charles Spaniel x Basset Hound mix)
Basset Bluetick - (Basset Hound x Bluetick Coonhound mix)
Basset Bordeaux - (Basset Hound x Dogue de Bordeaux mix)
Basset Foxhound - (Basset Hound x Foxhound mix)
Basset Heeler - (Basset Hound x Blue Heeler mix)
Basset Jack - (Basset Hound x Jack Russell Terrier mix)
Basset Retriever - (Basset Hound x Golden Retriever mix)
Basset Shepherd - (Basset Hound x German Shepherd mix)
Bassetoodle - (Basset Hound x Poodle mix)
Bassky - (Basset Hound x Siberian Husky mix)
Bassmatian - (Basset Hound x Dalmatian mix)
Basston - (Basset Hound x Boston Terrier mix)
Bassugg - (Basset Hound x Pug mix)
BD Terrier - (American Bulldog x Bull Terrier mix)
Be-Apso - (Beagle x Lhasa Apso mix)
Bea Griffon - (Beagle x Brussels Griffon mix)
Bea-Tzu - (Beagle x Shih Tzu mix)
Beabull - (Beagle x Bulldog mix)
Beacol - (Beagle x Bearded Collie mix)
Beagi - (Beagle x Pembroke or Cardigan Welsh Corgi mix)
Beagleman - (Beagle x Doberman Pinscher mix)
Beaglemation - (Beagle x Dalmatian mix)
Beagle Chin - (Beagle x Japanese Chin mix)
Beagle Heeler - (Beagle x Australian Cattle Dog mix)
Beagle Pit - (Beagle x Pit Bull mix)
Beagle Point - (Beagle x Pointer mix)
Beagle Sheltie - (Beagle x Shetland Sheepdog mix)
Beagle Shepherd - (Beagle x German Shepherd mix)
Beaglier - (Beagle x Cavalier King Charles mix)
Beaglolo - (Beagle x Bolognese mix)
Beago - (Beagle x Golden Retriever mix)
Beardoodle - (Bearded Collie x Poodle mix)
Beaski - (Beagle x Siberian Husky mix)
Beauceroodle - (Beauceron x Poodle mix)
Bebasset Bordeaux - (Beagle x Basset Hound x Dogue de Bordeaux mix)
Bedlington Whippet - (Bedlington Terrier x Whippet mix)
Belgian Shepadoodle - (Belgian Shepherd x Poodle mix)
Belusky - (Belgian Malinois x Siberian Husky mix)
Bernedoodle - (Bernese Mountain Dog x Poodle mix)
Bernefie - (Bernese Mountain Dog x Newfoundland mix (pronounced burn-ah-fee)
Berner Chow - (Bernese Mountain Dog x Chow Chow mix)
Berner Dane - (Great Dane x Bernese Mountain Dog mix)
Bernese Cattle Dog - (Bernese Mountain Dog x Australian Cattle Dog mix)
Bernese Rottie - (Bernese Mountain Dog x Rottweiler mix)
Bich-poo - (Bichon Frise x Poodle mix)
Bichomo - (American Eskimo x Bichon Frise mix)
Bichon-A-Ranian - (Bichon Frise x Pomeranian mix)
Bichon Yorkie - (Bichon Frise x Yorkshire Terrier mix)
Biton - (Bichon Frise x Coton de Tulear mix)
Black and Tan Coonoodle - (Poodle x Black and Tan Coonhound mix)
Black and Tan Coonshepherd - (Black and Tan Coonhound x German Shepherd mix)
Black and Tan Labhound - (Black and Tan Coonhound x Labrador Retriever mix)
Black Mouth Pom Cur - (Black Mouth Cur x Pomeranian mix)
Black Russian Wolfhound Terrier (Black Russian Terrier x Irish Wolfhound mix)
Bloodahouli - (Bloodhound x Catahoula mix)
Blue Blood Cane Corso - (Alapaha Blue Blood Bulldog x Cane Corso mix)
Blue Spaniel - (Australian Cattle Dog x Cocker Spaniel mix)
Blue-Tzu Heeler - (Australian Cattle Dog x Shih Tzu mix)
Bluetick Coonoodle - (Bluetick Coonhound x Poodle mix)
Bluetick Coonhound Harrier - (Bluetick Coonhound x Harrier mix)
Bluetick Rat Terrier - (Bluetick Coonhound x Rat Terrier mix)
Bluetick Walker - (Bluetick Coonhound x Treeing Walker Coonhound mix)
Bo-Dach - (Boston Terrier x Dachshund mix)
Bo-Jack - (Boston Terrier x Jack Russell Terrier mix)
Bocker - (Beagle x Cocker Spaniel mix)
Bodacion - (Border Collie x Dalmatian mix)
Boerboel Bernard - (Boerboel x Saint Bernard mix)
Boerboel Pei - (Boerboel x Shar Pei mix)
Boerboel Pit - (Boerboel x Pit Bull Terrier mix)
Boglen Terrier - (Beagle x Boston Terrier mix)
Bogle - (Beagle x Boxer mix)
Bolo-chi - (Bolognese x Chihuahua mix)
Bolo-Tzu - (Bolognese x Shih Tzu mix)
Bologco - (Bolognese x Cocker Spaniel mix)
Bololgnese Bolonka - (Bichon Bolognese x Russian Tsvetnaya Bolonka mix)
Bolonauzer - (Bolognese x Schnauzer mix)
Bolonoodle - (Bolognese x Poodle mix)
Bolosilk - (Bolognese x Silky Terrier mix)
Borador - (Border Collie x Labrador Retriever mix)
Bordeaux Pitbull - (Dogue de Bordeaux x Pit Bull mix)
Border Akbash Collie - (Border Collie x Akbash Dog mix)
Border Akita Collie - (Border Collie x Akita mix)
Border-Aussie - (Australian Shepherd x Border Collie mix)
Border Aussie Terrollie - (Border Collie x Australian Terrier mix)
Border Basset - (Border Collie x Basset Hound mix)
Border Beagle - (Border Collie x Beagle mix)
Border Bluetick Collie - (Border Collie x Bluetick Coonhound mix)
Border Chow - (Border Collie x Chow Chow mix)
Border Collie Bernard - (Border Collie x Saint Bernard mix)
Border Collie Britt - (Border Collie x Brittany Spaniel mix)
Border Collie Bull Staffy - (Border Collie x Staffordshire Bull Terrier mix)
Border Collie Cocker - (Border Collie x Cocker Spaniel mix)
Border Collie Lakeland - (Border Collie x Lakeland Terrier mix)
Border Collie Pit - (Border Collie x Pit Bull Terrier mix)
Border Collie Pyrenees - (Border Collie x Great Pyrenees mix)
Border Heeler - (Border Collie x Australian Cattle Dog (Blue Heeler) mix)
Border Jack - (Border Collie x Jack Russell Terrier mix)
Border Kelpie - (Border Collie x Australian Kelpie mix)
Border Malamute Collie - (Border Collie x Alaskan Malamute mix)
Border Malamute Terrier - (Border Terrier x Alaskan Malamute mix)
Border Newfie - (Border Collie x Newfoundland mix)
Border Point - (Border Collie x Pointer mix)
Border Pom - (Border Collie x Pomeranian mix)
Border Rottie - (Border Collie x Rottweiler mix)
Border Schnollie - (Border Collie x Schnauzer mix)
Border Sheepdog - (Border Collie x Shetland Sheepdog mix)
Border Springer - (Border Collie x English Springer Spaniel mix)
Border Stack - (Border Collie mixed with Jack Russell Terrier x Staffordshire Bull Terrier mix)
Border Whipollie - (Border Collie x Whippet mix)
Bordernese - (Bernese Mountain Dog x Border Collie mix)
Bordoodle - (Border Collie x Poodle mix)
Borgi - (Border Collie x Welsh Corgi mix)
Borollie - (Border Collie x Collie mix)
Bosapso - (Boston Terrier x Lhasa Apso mix)
BoShih - (Boston Terrier x Shih Tzu mix)
Boskimo - (American Eskimo x Boston Terrier mix)
Bosmaraner - (Boston Terrier x Weimaraner mix)
Bospin - (Boston Terrier x Miniature Pinscher mix)
Bossi-Poo - (Boston Terrier x Poodle mix)
Bossie - (Boston Terrier x Australian Shepherd mix)
Bostalian - (Boston Terrier x Italian Greyhound mix)
Bostchon - (Boston Terrier x Bichon Frise mix)
Bostie - (Boston Terrier x West Highland White Terrier mix)
Bostillon - (Boston Terrier x Papillon mix)
Bostinese - (Boston Terrier x Pekingese mix)
Boston Border Collie - (Boston Terrier x Border Collie mix)
Boston Boxer - (Boston Terrier x Boxer mix)
Boston Cattle Dog - (Australian Cattle Dog x Boston Terrier mix)
Boston Chin - (Boston Terrier x Japanese Chin mix)
Boston Huahua - (Boston Terrier x Chihuahua mix)
Boston Iggy - (Boston Terrier x Italian Greyhound mix)
Boston Lab - (Boston Terrier x Labrador Retriever mix)
Boston Malterrier - (Boston Terrier x Maltese mix)
Boston Mastiff Terrier - (Boston Terrier x English Mastiff mix)
Boston Spaniel - (Boston Terrier x Cocker Spaniel mix)
Boston Yorkie - (Boston Terrier x Yorkshire Terrier mix)
Bouberman - (Bouvier des Flandres x Doberman Pinscher mix)
Bouvador - (Bouvier des Flandres x Labrador Retriever mix)
Boweimar - (Boxer x Weimaraner mix)
Bowzer - (Basset Hound x Miniature Schnauzer mix)
Box-a-Pug - (Boxer x Pug mix)
Box-a-Shar - (Boxer x Shar-Pei mix)
Box Heeler - (Boxer x Blue Heeler mix)
Boxer Bloodhound - (Bloodhound x Boxer mix)
Boxer Chow - (Boxer x Chow Chow mix)
Boxer Jack - (Boxer x Jack Russell Terrier mix)
Boxer Shepherd - (Boxer x German Shepherd mix)
Boxer Whippet - (Boxer x Whippet mix)
Boxachi - (Boxer x Chihuahua mix)
Boxador - (Boxer x Labrador Retriever mix)
Boxane - (Boxer x Great Dane mix)
Boxapoint - (Boxer x German Shorthaired Pointer mix)
Boxer Basset - (Boxer x Basset Hound mix)
Boxerdoodle - (Boxer x Poodle mix)
Boxerman - (Boxer x Doberman Pinscher mix)
Boxita - (Akita x Boxer mix)
Boxmas - (Boxer x Mastiff mix)
Boxmatian - (Boxer x Dalmatian mix)
Boxollie - (Boxer x Collie mix)
Boxsky - (Boxer x Siberian Husky mix)
Boxspring - (Boxer x English Springer Spaniel mix)
Boxweiler - (Rottweiler x Boxer mix)
Brat - (Boston Terrier x Rat Terrier mix)
Bridoodle - (Briard x Poodle mix)
Brittany Beagle - (Brittany x Beagle mix)
Brittany Bourbonnais - (Brittany Spaniel x Braque du Bourbonnais mix)
Brittnepoo - (Brittany Spaniel x Poodle mix)
Broholmer Pit - (Broholmer x American Pit Bull Terrier mix)
Broodle Griffon - (Brussels Griffon x Poodle mix)
Brottweiler - (Brussels Griffon x Rottweiler mix)
Brug - (Brussels Griffon x Pug mix)
Brussalier - (Brussels Griffon x Cavalier King Charles Spaniel mix)
Brusselranian - (Brussels Griffon x Pomeranian mix)
Brusston - (Boston Terrier x Brussels Griffon mix)
BT Walker - (Boxer x Treeing Walker Coonhound mix)
Buggs - (Boston Terrier x Pug mix)
Bull-Aussie - (English Bulldog x Australian Shepherd mix)
Bull-Boxer - (English Bulldog x Boxer mix)
Bull Chow Terrier - (Bull Terrier x Chow Chow mix)
Bull Daniff - (Bullmastiff x Great Dane mix)
Bull Greyhound Terrier - (Greyhound x Bull Terrier mix)
Bull Heeler Terrier - (Bull Terrier x Australian Cattle Dog mix)
Bull Jack - (Bulldog x Jack Russell Terrier mix)
Bull Mastweiler - (Bullmastiff x Rottweiler mix)
Bull-Pei - (Bulldog x Chinese Shar-Pei mix)
Bullador - (English Bulldog x Labrador Retriever mix)
Bullbasset Mastiff - (Bullmastiff x Basset Hound mix)
Bullboxer Pit - (Boxer x American Pit Bull Terrier mix)
Bullboxer Staff - (Boxer x American Staffordshire Terrier mix)
Bullboxer Staffy Bull - (Boxer x Staffordshire Bull Terrier mix)
Bulldog Schnauzer - (Bulldog (English) x Miniature Schnauzer mix)
Bullhuahua - (Bulldog x Chihuahua mix)
Bullhuahua Terrier - (Bull Terrier x Chihuahua mix)
Bullkita - (American Bulldog x Akita mix)
Bullmasador - (Bullmastiff x Labrador Retriever mix)
Bullmastiff Shepherd - (Bullmastiff x German Shepherd mix)
Bullmatian - (Bulldog x Dalmatian mix)
Bullmatian Terrier - (Bull Terrier x Dalmatian mix)
Bulloxer - (Boxer x American Bulldog mix)
Bullsky Mastiff - (Bullmastiff x Siberian Husky mix)
Bullwhip - (Bulldog x Whippet mix)
Bully Basset - (Basset Hound x Bulldog mix)
Bully Bordeaux - (Bullmastiff x Dogue de Bordeaux mix)
Bully Chi - (American Bully x Chihuahua mix)
Bully Kutta Lab - Bully Kutta x Labrador Retriever mix
Bully Jack Terrier - (Bull Terrier x Jack Russell Terrier mix)
Bully Pitsky - (American Bully x Siberian Husky or Alaskan Husky mix)
Bully-Tzu - (Bulldog x Shih Tzu mix)
Bully Wheaten - (Bulldog x Soft Coated Wheaten Terrier mix)
Bullypit - (American Bulldog x American Pit Bull Terrier mix)
Bushland Terrier - (Cairn Terrier x Scottish Terrier mix)
A | B | C | D | E | F | G | H | I | J | K | L | M | N | O | P-Q | R | S | T | U-V | W | X-Y-Z
Cadoodle - (Collie x Poodle mix)
Cairanian - (Cairn Terrier x Pomeranian mix)
Cairicocker - (Cairn Terrier x Cocker Spaniel mix)
Cairland Terrier - (Cairn Terrier x Westie mix)
Cairmal - (Cairn Terrier x Maltese mix)
Cairn Beagle - (Cairn Terrier x Beagle mix)
Cairn Chin - (Cairn Terrier x Japanese Chin mix)
Carin Australian Shepterrier - (Australian Shepherd x Cairn Terrier mix)
Cairn Corgi - (Cairn Terrier x Welsh Corgi mix)
Cairnese - (Cairn Terrier x Havanese mix)
Cairnoodle - (Cairn Terrier x Poodle mix)
Cairnwich Terrier - (Cairn Terrier x Norwich Terrier mix)
Cairoston - (Cairn Terrier x Boston Terrier mix)
Cane Corxer - (Cane Corso Italiano x Boxer mix)
Cardigan Corgi Pointer - (Cardigan Welsh Corgi x Pointer mix)
Cardigan Corman Shepherd - (Cardigan Welsh Corgi x German Shepherd mix)
Cardigan Corswiss - (Cardigan Welsh Corgi x Greater Swiss Mountain Dog mix)
Cardigan Pembroke Corgi - (Cardigan Welsh Corgi x Pembroke Welsh Corgi mix)
Care-Tzu - (Cairn Terrier x Shih Tzu mix)
Carengi - (Carolina Dog x Basenji mix)
Carkie - (Cairn Terrier x Yorkshire Terrier mix)
Carnauzer - (Cairn Terrier x Miniature Schnauzer mix)
Catahoula Bulldog - (Louisiana Catahoula Leopard Dog x American Bulldog mix)
Catahoula Dane - (Catahoula Leopard Dog x Great Dane mix)
Catahoula English Bulldog - (Louisiana Catahoula Leopard Dog x English Bulldog mix)
Catahoula Heeler - (Louisiana Catahoula Leopard Dog x Australian Cattle Dog mix)
Catahoula Rottie - (Louisiana Catahoula Leopard Dog x Rottweiler mix)
Catahoula Whippet - (Louisiana Catahoula Leopard Dog x Whippet mix)
Cattle Collie Dog - (Australian Cattle Dog x Collie mix)
Cattle Shepherd - (Australian Cattle Dog x German Shepherd mix)
Caucasian Husky - (Caucasian Shepherd Dog x Husky mix)
Caucasian Staffy Bull - (Caucasian Shepherd Dog x Staffordshire Bull Terrier mix)
Cav-A-Malt - (Cavalier King Charles x Maltese mix)
Cav-A-Mo - (American Eskimo x Cavalier King Charles Spaniel mix)
Cava-Chin - (Cavalier King Charles x Japanese Chin mix)
Cava-Corgi - (Cavalier King Charles Spaniel x Pembroke Welsh Corgi mix)
Cav-A-Jack - (Cavalier King Charles Spaniel x Jack Russell Terrier mix)
Cava Inu - (Cavalier King Charles Spaniel x Shiba Inu mix)
Cava-lon - (Cavalier King Charles x Papillon mix)
Cava-Tzu - (Cavalier King Charles x Shih Tzu mix)
Cavachon - (Bichon Frise x Cavalier King Charles Spaniel mix)
Cavador - (Cavalier King Charles Spaniel x Labrador Retriever mix)
Cavanese - (Cavalier King Charles Spaniel x Havanese mix)
Cavapom - (Cavalier King Charles Spaniel x Pomeranian mix)
Cavapoo - (Cavalier King Charles Spaniel x Poodle mix)
Cavaton - (Cavalier King Charles x Coton de Tulear mix)
Cava-Shell - (Cavalier King Charles Spaniel x Shetland Sheepdog mix)
Cavestie - (Cavalier King Charles Spaniel x West Highland White Terrier mix)
Cavottish - (Cavalier King Charles x Scottish Terrier mix)
Chabrador - (Chow Chow x Labrador Retriever mix)
Chatham Hill Retriever - (Flat-Coated Retriever x Cocker Spaniel mix)
Chatterdale - (Chihuahua x Patterdale mix)
Cheagle - (Chihuahua x Beagle mix)
Cheeks - (Chihuahua x Pekingese mix)
Cheenese - (Chihuahua x Havanese mix)
Cherokee Monarch - (Papillon x Russian Toy Terrier mix)
Chesa-Poo - (Chesapeake Bay Retriever x Poodle mix)
Chesador - (Chesapeake Bay Retriever x Labrador Retriever mix)
Crested Boxer - (Chinese Crested x Boxer mix)
Chestie - (Chihuahua x West Highland White Terrier mix)
Chi Apso - (Chihuahua x Lhasa Apso mix)
Chi-Chi - (Chihuahua x Chinese Crested mix)
Chi-Chon - (Bichon Frise x Chihuahua mix)
Chidale - (Chihuahua x Airedale Terrier mix)
Chi-Poo - (Chihuahua x Poodle mix)
Chi-Spaniel - (Chihuahua x Cocker Spaniel mix)
Chi Staffy - (Chihuahua x Staffordshire Terrier mix)
Chi Staffy Bull - (Chihuahua x Staffordshire Bull Terrier mix)
Chigi - (Chihuahua x Corgi mix)
Chilier - (Cavalier King Charles x Chihuahua mix)
Chimation - (Chihuahua x Dalmatian mix)
Chimo - (Chihuahua x American Eskimo Dog mix)
Chin Crested - (Chinese Crested x Japanese Chin mix)
Chin-Fenpinscher - (Affenpinscher x Japanese Chin mix)
Chin-Ocker - (Cocker Spaniel x Japanese Chin mix)
Chin-Pin - (Miniature Pinscher x Japanese Chin mix)
Chin-wa - (Chihuahua x Japanese Chin mix)
China Jack - (Chinese Crested x Jack Russell Terrier mix)
Chinaranian - (Chinese Crested x Pomeranian mix)
Chineranian - (Japanese Chin x Pomeranian mix)
Chinese Crestepoo - (Chinese Crested x Poodle mix)
Chinese Crestese - (Chinese Crested x Maltese mix)
Chinese Frise - (Bichon Frise x Chinese Crested mix)
Chion - (Chihuahua x Papillon mix)
Chipin - (Chihuahua x Miniature Pinscher mix)
Chipit - (Chihuahua x American Pit Bull Terrier mix)
Chisenji - (Chihuahua x Basenji mix)
Chiweenie - (Chihuahua x Dachshund mix)
Chiwoxy - (Chihuahua x Wire Fox Terrier mix)
Chizer - (Chihuahua x Miniature Schnauzer mix)
Chonzer - (Bichon Frise x Miniature Schnauzer mix)
Chorkie - (Chihuahua x Yorkshire Terrier mix)
Chow Hound Basset - (Chow Chow x Basset Hound mix)
Chow Pei - (Chow Chow x Shar Pei mix)
Chowpit - (Chow Chow x American Pit Bull Terrier mix)
Chow Shepherd - (Chow Chow x Shepherd mix)
Chug - (Chihuahua x Pug mix)
Chusky - (Chow Chow x Siberian Husky mix)
Chussel - (Brussels Griffon x Chihuahua mix)
Chuvasz - (Chow Chow x Kuvasz mix)
Carillon - (Cairn Terrier x Papillon mix)
Clumber Lab - (Clumber Spaniel x Labrador Retriever mix)
Clumber Pei - (Clumber Spaniel x Chinese Shar Pei mix)
Clumberton - (Clumber Spaniel x Bedlington Terrier mix)
Cluminger Spaniel - (Clumber Spaniel x English Springer mix)
Clumberstiff - (Clumber Spaniel x Bullmastiff mix)
Cock-A-Chon - (Bichon Frise x Cocker Spaniel mix)
Cock-A-Mo - (American Eskimo x Cocker Spaniel mix)
Cock-A-Tzu - (Cocker Spaniel x Shih Tzu mix)
Cockalier - (Cavalier King Charles x Cocker Spaniel mix)
Cockapin - (Cocker Spaniel x Miniature Pinscher mix)
Cockapoo - (Cocker Spaniel x Poodle mix)
Cocker Chow - (Cocker Spaniel x Chow Chow mix)
Cocker Griffon - (Cocker Spaniel x Brussels Griffon mix)
Cocker Jack - (Cocker Spaniel x Jack Russell Terrier mix)
Cocker-Pei - (Cocker Spaniel x Chinese Shar Pei mix)
Cocker Pug - (Cocker Spaniel x Pug mix)
Cocker Sheltie - (Cocker Spaniel x Shetland Sheepdog mix)
Cocker-Ton - (Cocker Spaniel x Coton de Tulear mix)
Cocker Weim - (Cocker Spaniel x Weimaraner mix)
Cocker Westie - (Cocker Spaniel x West Highland White Terrier mix)
Cocker Wheaten - (Cocker Spaniel x Soft Coated Wheaten Terrier mix)
Cockeranian - (Cocker Spaniel x Pomeranian mix)
Cockerbull - (Cocker Spaniel x English Bulldog mix)
Cockinese - (Cocker Spaniel x Pekingese mix)
Cojack - (Jack Russell Terrier x Pembroke Welsh Corgi mix)
Collie Pyrenees - (Collie x Great Pyrenees mix)
Colonial Cocker Spaniel - (American Cocker Spaniel x English Cocker Spaniel mix)
Confetti Australian Shepherd - (Australian Shepherd x Miniature Schnauzer mix)
Copica - (Corgi x Cockapoo mix)
Corgi Basset - (Basset Hound x Welsh Corgi mix)
Corgi Bichon - (Corgi x Bichon Frise mix)
Corgi Cattle Dog - (Australian Cattle Dog x Pembroke Welsh Corgi mix)
Corgi-Flat - (Corgi x Flat-Coated Retriever mix)
Corgi Pit - (Welsh Corgi x American Pit Bull Terrier mix)
Corgi Pointer - (Corgi x Pointer mix)
Corgi Pug - (Welsh Corgi x Pug mix)
Corgi Schip - (Welsh Corgi x Schipperke mix)
Corgidor - (Labrador Retriever x Corgi mix)
Corgipoo - (Corgi x Poodle mix)
Corgiranian - (Corgi x Pomeranian mix)
Corillon - (Papillon x Pembroke Welsh Corgi mix)
Corkie - (Cocker Spaniel x Yorkie mix)
Corman Shepherd - (Corgi x German Shepherd mix)
Corpin - (Corgi x Miniature Pinscher mix)
Corsengi -(Welsh Corgi x Basenji mix)
Corswiss - (Welsh Corgi x Greater Swiss Mountain Dog mix)
Cortese - (Welsh Corgi x Maltese mix)
Cosheltie - (Collie x Shetland Sheepdog mix)
Coton-Beagle - (Coton de Tulear x Beagle mix)
Coton Bolonka - (Coton de Tulear x Russian Tsvetnaya Bolonka mix)
Coton Chin - (Coton de Tulear x Japanese Chin mix)
Coton Eskimo - (American Eskimo x Coton de Tulear mix)
Coton Mi-ki - (Coton de Tulear x Miki mix)
Coton Schnauzer - (Coton de Tulear x Miniature Schnauzer mix)
Coton Tzu - (Coton De Tulear x Shih Tzu mix)
Cotonese - (Coton de Tulear x Maltese mix)
Cotralian - (Cocker Spaniel x Australian Shepherd mix)
Cotralian - (Cocker Spaniel x Standard, Miniature or Toy Australian Shepherd mix)
Coydog - (Domestic Dog x Coyote mix)
Crested Apso = (Chinese Crested x Lhasa Apso mix)
Crested Beagle - (Chinese Crested x Beagle mix)
Crested Cavalier - (Chinese Crested x Cavalier King Charles Spaniel mix)
Crested Chin - (Chinese Crested x Chin mix)
Crested Cocker - (Chinese Crested x Cocker Spaniel mix)
Crested Havanese - (Chinese Crested x Havanese mix)
Crested Malt - (Chinese Crested x Maltese mix)
Crested Peke - (Chinese Crested x Pekingese mix)
Crested Schnauzer - (Chinese Crested x Miniature Schnauzer mix)
Crested Tzu - (Chinese Crested x Shih Tzu mix)
Crested Westie - (Chinese Crested x West Highland White Terrier)
Crestoxie - (Chinese Crested x Dachshund mix)
Croatian Sheepsky - (Croatian Sheepdog x Siberian Husky mix)
Crustie - (Chinese Crested x Yorkshire Terrier mix)
Cursset - (Black Mouth Cur x Basset Hound mix)
A | B | C | D | E | F | G | H | I | J | K | L | M | N | O | P-Q | R | S | T | U-V | W | X-Y-Z
Dach-Griffon - (Dachshund x Brussels Griffon mix)
Dachsador - (Dachshund x Labrador Retriever mix)
Dachsi Apso - (Dachshund x Lhasa Apso mix)
Dachsweiler - (Dachshund x Rottweiler mix)
Daisy Dog - (Bichon x Poodle x Shih-Tzu mix)
Dalmadoodle - (Dalmatian x Poodle mix)
Dalmador - (Labrador Retriever x Dalmatian mix)
Dalmatian Feist - (Dalmatian x Mountain Feist mix)
Dalmatian Heeler -(Dalmatian x Australian Cattle Dog mix)
Dalmatian Husky - (Dalmatian x Siberian Husky mix)
Dalmatian Springer - (Dalmatian x English Springer Spaniel mix)
Dameranian - (Dachshund x Pomeranian mix)
Dane Shepherd - (Great Dane x German Shepherd mix)
Daniff - (Great Dane x Mastiff mix)
Dashalier - (Dachshund x Cavalier King Charles Spaniel mix)
Daug - (Dachshund x Pug mix)
Decker Brat - (Decker Hunting Terrier x Boston Terrier mix)
Deerhound Shepherd - (Scottish Deerhound x German Shepherd mix)
Dingo Kelpie - (Dingo x Australian Kelpie mix)
Dingo Podenco - (Dingo x Andalusian Podenco mix)
Doberman Greyhound - (Doberman Pinscher x Greyhound mix)
Doberdane - (Doberman Pinscher x Great Dane mix)
Doberdor - (Doberman Pinscher x Labrador Retriever mix)
Doberghan - (Doberman Pinscher x Afghan Hound mix)
Doberman Bulldog - (Doberman Pinscher x Bulldog mix)
Doberman Collie - (Doberman Pinscher x Collie mix)
Doberman Pit - (Doberman Pinscher x American Pit Bull Terrier mix)
Doberman Shepherd - (Doberman Pinscher x German Shepherd mix)
Dobie-Basset - (Doberman Pinscher x Basset Hound mix)
Dobie Foxhound - (Doberman Pinscher x American Foxhound mix)
Dobie Heeler - (Doberman Pinscher x Australian Cattle Dog mix)
Dobie Schnauzer - (Doberman Pinscher x Schnauzer mix)
Dobieton - (Doberman Pinscher x Boston Terrier mix)
Dobocker - (Doberman Pinscher x Cocker Spaniel mix)
Dobsky - (Doberman Pinscher x Old English Sheepdog mix)
Docker - (Dachshund x Cocker Spaniel mix)
Dogo Pit - (Dogo Argentino x Pit Bull Terrier mix)
Dogue Brasileiro - (Bull Terrier x Boxer mix)
Dogue de Boxer - (Boxer x Dogue de Bordeaux mix)
Doguedoodle - (Dogue de Bordeaux x Poodle mix)
Doodleman Pinscher - (Doberman x Standard Poodle mix)
Dorgi - (Dachshund x Corgi mix)
Dorkie - (Dachshund x Yorkshire Terrier mix)
Doubull-Mastiff - (Bullmastiff x Mastiff mix)
Double Doodle - (Goldendoodle x Labradoodle mix)
Doxie Cairn - (Cairn Terrier x Dachshund mix)
Doxie-Chin - (Dachshund x Japanese Chin mix)
Doxie-Chon - (Bichon Frise x Dachshund mix)
Doxie Heeler - (Australian Cattle Dog x Dachshund mix)
Doxie Scot - (Dachshund x Scottish Terrier mix)
Doxie-Pin - (Dachshund x Miniature Pinscher mix)
Doxie-Pit - (Dachshund x American Pit Bull Terrier mix)
Doxiemo - (Dachshund x American Eskimo Dog mix)
Doxiepoo - (Dachshund x Poodle mix)
Doxle - (Beagle x Dachshund mix)
Dualanese - (Bolognese x Havanese mix) 
Dusky - (Dachshund x Siberian Husky mix)
Dutchie Chow Shepherd - (Dutch Shepherd x Chow Chow mix)
A | B | C | D | E | F | G | H | I | J | K | L | M | N | O | P-Q | R | S | T | U-V | W | X-Y-Z
Elk-a-Bee - (Norwegian Elkhound x Beagle mix)
Elkhound Shepherd - (Norwegian Elkhound x German Shepherd mix)
Elk-Kee - (Keeshond x Norwegian Elkhound mix)
Eng-A-Poo - (English Toy Spaniel x Poodle mix)
Enga-Apso - (English Toy Spaniel x Lhasa Apso mix)
Engachon - (Bichon Frise x English Toy Spaniel mix)
EngAm Bulldog x Olde Bulldog - (American Bulldog x English Bulldog mix)
Enganese - (English Toy Spaniel x Havanese mix)
Engatzu Spaniel - (English Toy Spaniel x Shih Tzu mix)
Englian Mastiff - (English Mastiff x Neapolitan Mastiff mix)
English Boodle - (English Bulldog x Poodle mix)
English Borsetter Collie - (Border Collie x English Setter mix)
English Boston-Bulldog - (Boston Terrier x English Bulldog mix)
English Boxetter - (English Setter x Boxer mix)
English Bull Dane - (English Bulldog x Great Dane mix)
English Bull Springer - (Bulldog x English Springer Spaniel mix)
English Bull Terrier Pit - (Bull Terrier x Pit Bull Terrier mix)
English Bullamute - (Bulldog x Alaskan Malamute mix)
English Bull Staffy - (English Bulldog x American Staffordshire Terrier mix)
English Bull-Walker - (Bulldog x Treeing Walker mix)
English Bullweiler - (English Bulldog x Rottweiler mix)
English Bulldog Terrier - (English Bulldog x Bull Terrier mix)
English Bulltyme - (English Bulldog x Olde Tyme Bulldog mix)
English Bully Staffy Bull Terrier - (English Bulldog x Staffordshire Bull Terrier mix)
English Catahoula Shepherd - (English Shepherd x Louisiana Catahoula Leopard Dog mix)
English Cocker Chow - (English Cocker Spaniel x Chow Chow mix)
English Collie Shepherd - (English Shepherd x Collie mix)
English Coonoodle - (English Coonhound x Poodle mix)
English Coon Rottie - (American English Coonhound x Rottweiler mix)
English Cotralian - (English Cocker Spaniel x Standard, Miniature or Toy Australian Shepherd mix)
English King - (Cavalier King Charles x English Toy Spaniel mix)
English Lhasa Bull - (English Bulldog x Lhasa Apso mix)
English Mastahoula - (English Mastiff x Louisiana Catahoula Leopard Dog mix)
English Mastweiler - (Mastiff x Rottweiler mix)
English Mini Foxker - (English Cocker Spaniel x Miniature Fox Terrier mix)
English Neo Bull - (Bulldog x Neapolitan Mastiff mix)
English Presa Bulldog - (English Bulldog x Presa Canario mix)
English Spanador - (English Cocker Spaniel x Labrador Retriever mix)
English Spantriever - (English Cocker Spaniel x Labrador Retriever mix)
English Speagle - (Beagle x English Toy Spaniel mix)
English Springerman - (Doberman Pinscher x English Springer Spaniel mix)
English Sprointer - (English Pointer x English Springer Spaniel mix)
English Toy Chin Spaniel - (English Toy Spaniel x Japanese Chin mix)
English Toy Cocker Spaniel - (Cocker Spaniel x English Toy Spaniel mix)
English Toy Griffon - (Brussels Griffon x English Toy Spaniel mix)
English Toy Papillon - (Papillon x English Toy Spaniel mix)
English Toy Spanese - (English Toy Spaniel x Pekingese mix)
Entlebucher Pit - (Entlebucher Mountain Dog x American Pit Bull Terrier mix)
Eskapoo - (American Eskimo Dog x Poodle mix)
Eskenji - (American Eskimo x Basenji  mix)
Eskidor - (American Eskimo x Labrador Retriever mix)
Eskifon - (American Eskimo x Brussels Griffon mix)
Eskijack - (American Eskimo x Jack Russell Terrier mix)
Eskimo Chi - (American Eskimo x Chihuahua mix)
Eskimo Chin - (Chin x American Eskimo Dog mix)
Eskimo Pit - (American Pit Bull Terrier x American Eskimo Dog mix)
Eskimo Schnauzer - (American Eskimo x Schnauzer mix)
Eskimo Shepherd - (American Eskimo x German Shepherd mix)
Eskimo Yorkie - (American Eskimo x Yorkshire Terrier mix)
Eskland - (American Eskimo x Shetland Sheepdog mix)
Euro Mountain Sheparnese - (Bernese Mountain Dog x German Shepherd mix)
Ewokian - (Havanese x Pomeranian mix)
A | B | C | D | E | F | G | H | I | J | K | L | M | N | O | P-Q | R | S | T | U-V | W | X-Y-Z
Faux Frenchbo Bulldog - (Boston Terrier x French Bulldog mix)
Feist Chi - (Mountain Feist x Chihuahua mix)
Feist Tzu - (Mountain Feist x Shih Tzu mix)
Fila Tosa - (Fila Brasileiro x Japanese Tosa mix)
Finnish Chow Spitz - (Finnish Spitz x Chow Chow mix)
Flandoodle - (Bouvier des Flandres x Poodle mix)
Fo-Tzu - (Shih Tzu x Toy Fox Terrier mix)
Foodle - (Poodle x Toy Fox Terrier mix)
Fourche Terrier - (Westie x Yorkshire Terrier mix)
Foxhoodle - (Fox Hound x Poodle mix)
Foxingese - (Pekingese x Fox Terrier mix)
Foxker - (Cocker Spaniel x Fox Terrier mix)
Foxton - (Boston Terrier x Toy Fox Terrier mix)
Foxy Rat Terrier - (American Rat Terrier x Toy Fox Terrier mix)
Foxy Russell - (Jack Russell Terrier x Toy Fox Terrier mix)
Free-Lance Bulldog - (French Bulldog x Bulldog mix)
French Afghan Mastiff - (Dogue de Bordeaux x Afghan Hound mix)
French Buillon - (French Bulldog x Papillon mix)
French Bull Dane - (French Bulldog x Great Dane mix)
French Bull Jack - (French Bulldog x Jack Russell Terrier mix)
French Bull Rat Terrier - (French Bulldog x American Rat Terrier mix)
French Bull Terrier - (French Bulldog x Bull Terrier mix)
French Bull Tzu - (French Bulldog x Shih Tzu mix)
French Bull Weiner - (French Bulldog x Dachshund mix)
French Bullhuahua - (French Bulldog x Chihuahua mix)
French Bullnese - (French Bulldog x Pekingese mix)
French Bulloxer - (Boxer x French Bulldog mix)
French Bullweiler - (French Bulldog x Rottweiler mix)
French Masti-Bull - (French Bulldog x Mastiff mix)
French Mastahoula - (French Mastiff x Louisiana Catahoula Leopard Dog mix)
French Pin - (French Bulldog x Miniature Pinscher mix)
French West Highlander - (French Bulldog x West Highland White Terrier mix)
Frenchie Bichon - (French Bulldog x Bichon Frise mix)
Frenchie Labrador - (French Bulldog x Labrador Retriever mix)
Frenchie-Pei - (French Bulldog x Chinese Shar Pei mix)
Frenchie Pug - (French Bulldog x Pug mix)
Frenchie Shepherd - (French Bulldog x German Shepherd mix)
Frenchie Staff - (French Bulldog x American Staffordshire Terrier mix)
Frenchnese - (French Bulldog x Havanese mix)
Frengle - (French Bulldog x Beagle mix)
Froodle - (French Bulldog x Poodle mix)
A | B | C | D | E | F | G | H | I | J | K | L | M | N | O | P-Q | R | S | T | U-V | W | X-Y-Z
Gerberian Shepsky - (German Shepherd x Siberian Husky mix)
German Anatolian Shepherd - (German Shepherd x Anatolian Shepherd mix)
German Australian Shepherd - (German Shepherd x Australian Shepherd mix)
German Groenendael - (German Shepherd x Belgian Shepherd mix)
German Hund Pointer - (German Wirehaired Pointer x Dachshund mix)
German Longhaired Sprointer - (German Longhaired Pointer x English Springer Spaniel mix)
German Malinois - (Belgian Malinois x German Shepherd Dog mix)
German Pointeraner - (German Shorthaired Pointer x Weimaraner mix)
German Sheltie Spitz - (German Spitz x Shetland Sheepdog mix)
German Sheprador - (German Shepherd Dog x Labrador Retriever mix)
German Shorthair Toller - (German Shorthaired Pointer x Nova Scotia Duck Tolling Retriever mix)
German Shorthaired Lab - (German Shorthaired Pointer x Labrador Retriever mix)
German Shorthaired Pointerpoodle - (German Shorthaired Pointer x Poodle mix)
German Shorthaired Sprointer - (German Shorthaired Pointer x English Springer Spaniel mix)
German Shorthaired Weimaraner - (German Shorthaired Pointer x Weimaraner mix)
German Spitz Shepherd - (German Spitz x German Shepherd mix)
German Spitzpoo - (German Spitz x Poodle mix)
German Wirehaired Lab - (German Wirehaired Pointer x Labrador Retriever mix)
German Wirehaired Newfie - (German Wirehaired Pointer x Newfoundland mix)
German Wirehaired Pointing Vizsla - (German Wirehaired Pointer x Vizsla mix)
German Wirehaired Pointing Wolfhound - (German Wirehaired Pointer x Irish Wolfhound mix)
German Wirehaired Sprointer - (German Wirehaired Pointer x English Springer Spaniel mix)
German Yorkie Shepherd - (German Shepherd x Yorkshire Terrier mix)
Germanees - (German Shepherd x Great Pyrenees mix)
Giant Bolonauzer - (Bolognese x Giant Schnauzer mix)
Giant Border Schnollie - (Border Collie x Giant Schnauzer mix)
Giant Irish Wolf Schnauzer - (Giant Schnauzer x Irish Wolfhound mix)
Giant Kerry Blue Schnauzer - (Giant Schnauzer x Kerry Blue Terrier mix)
Giant Komondauzer - (Giant Schnauzer x Komondor mix)
Giant Ratzer - (Giant Schnauzer x Rat Terrier mix)
Giant Schnauzer Chin - (Japanese Chin x Giant Schnauzer mix)
Giant Schnoodle - (Giant Schnauzer x Standard Poodle mix)
Giant Wauzer - (Westie x Giant Schnauzer mix)
Giant Wire Hair Snauzer - (Giant Schnauzer x Wire Fox Terrier mix)
Glechon - (Beagle x Bichon Frise mix)
Goberian - (Golden Retriever x Siberian Husky mix)
Golden Akita Retriever - (Golden Retriever x Akita mix)
Golden Border Retriever - (Golden Retriever x Border Collie mix)
Golden Boxer - (Golden Retriever x Boxer mix)
Golden Bulldog - (Golden Retriever x Bulldog mix)
Golden Bullmastiff Retriever - (Bullmastiff x Golden Retriever mix)
Golden Cavalier - (Cavalier King Charles Spaniel x Golden Retriever mix)
Golden Chesabay - (Golden Retriever x Chesapeake Bay Retriever mix)
Golden Chi Retriever - (Golden Retriever x Chihuahua mix)
Golden Chow Retriever - (Golden Retriever x Chow Chow mix)
Golden Cocker Retriever - (Cocker Spaniel x Golden Retriever mix)
Golden Dox - (Golden Retriever x Dachshund mix)
Golden Indian Dog - (Golden Retriever x Native American Indian Dog mix)
Golden Irish - (Golden Retriever x Irish Setter mix)
Golden Jack Retriever - (Golden Retriever x Jack Russell Terrier mix)
Golden Labrador - (Golden Retriever x Labrador Retriever mix)
Golden Mastiff - (Golden Retriever x English Mastiff mix)
Golden Mountain Dog - (Golden Retriever x Bernese Mountain Dog mix)
Golden Newfie - (Golden Retriever x Newfoundland mix)
Golden Pei - (Chinese Shar Pei x Golden Retriever mix)
Golden Pyrenees - (Golden Retriever x Great Pyrenees mix)
Golden Rottie Retriever - (Golden Retriever x Rottweiler mix)
Golden Saint - (Golden Retriever x Saint Bernard mix)
Golden Sammy - (Golden Retriever x Samoyed mix)
Golden Sheltie - (Golden Retriever x Sheltie mix)
Golden Shepherd - (Golden Retriever x German Shepherd mix)
Golden Tibetan Tertriever - (Golden Retriever x Tibetan Terrier mix)
Golden Toller Retriever - (Golden Retriever x Nova Scotia Duck Tolling Retriever mix)
Goldenapso Retriever - (Golden Retriever x Lhasa Apso mix)
Goldendale - (Golden Retriever x Airedale Terrier mix)
Goldenshire - (Golden Retriever x Yorkshire Terrier mix)
Goldendoodle - (Golden Retriever x Poodle mix)
Goldmaraner - (Golden Retriever x Weimaraner mix)
Goldmation - (Golden Retriever x Dalmatian mix)
Gollie - (Golden Retriever x Collie mix)
Gordon Chesabay - (Gordon Setter x Chesapeake Bay Retriever mix)
Gordon Sheltie - (Gordon Setter x Shetland Sheepdog mix)
Gordondoodle - (Gordon Setter x Poodle mix)
Great Bernese - (Bernese Mountain dog x Great Pyrenees mix)
Great Cambrian Shepherd - (Great Pyrenees x Welsh Sheepdog mix)
Great Danebull - (American Pit Bull Terrier x Great Dane mix)
Great Danesky - (Great Dane x Siberian Husky mix)
Great Danoodle - (Great Dane x Poodle mix)
Great Dasenji - (Great Dane x Basenji mix)
Great Golden Dane - (Golden Retriever x Great Dane mix)
Great Keeshees - (Great Pyrenees x Keeshond mix)
Great Pyredane - (Great Dane x Great Pyrenees mix)
Great Weimar - (Great Dane x Weimaraner mix)
Great Wirehaired Gryfenees - (Wirehaired Pointing Griffon x Great Pyrenees mix)
Great Wolfhound - (Great Pyrenees x Irish Wolfhound mix)
Greater Swiss Mountain Dane - (Greater Swiss Mountain Dog x Great Dane mix)
Greater Swiss Rottweiler - (Greater Swiss Mountain Dog x Rottweiler mix)  
Greater Welsh Corswiss - (Welsh Corgi x Greater Swiss Mountain Dog mix)
Greyador - (Greyhound x Labrador Retriever mix)
Greybull Pit - (American Pit Bull Terrier x Greyhound mix)
Greyhound Shepherd - (Greyhound x German Shepherd mix)
Griffairn Terrier - (Brussels Griffon x Cairn Terrier mix)
Griffichon - (Bichon Frise x Brussels Griffon mix)
Griffon-Pei - (Brussels Griffon x Chinese Shar-Pei mix)
Griffonese - (Brussels Griffon x Pekingese mix)
Griffonland - (Brussels Griffon x West Highland White Terrier mix)
Griffonshire - (Brussels Griffon x Yorkshire Terrier mix)
Groenendael Chow - (Belgian Shepherd x Chow Chow mix)
A | B | C | D | E | F | G | H | I | J | K | L | M | N | O | P-Q | R | S | T | U-V | W | X-Y-Z
Hava-Apso - (Havanese x Lhasa Apso mix)
Hava-Boston - (Havanese x Boston Terrier mix)
Hava-Jack - (Havanese x Jack Russell Terrier mix)
Hava Klee - (Havanese x Alaskan Klee Kai)
Hava-Welsh - (Havanese x Welsh Terrier mix)
Hava-Wheat - (Havanese x Soft Coated Wheaten Terrier mix)
Havachin - (Havanese x Japanese Chin mix)
Havachon - (Bichon Frise x Havanese mix)
Havaco - (Havanese x Cocker Spaniel mix) 
Havallon - (Havanese x Papillon mix)
Havamalt - (Havanese x Maltese mix)
Havanestie - (Havanese x West Highland Terrier mix)
Havapeke - (Havanese x Pekingese mix)
Havashire - (Havanese x Yorkshire Terrier mix)
Havashu - (Havanese x Shih Tzu mix)
Havaton - (Coton de Tulear x Havanese mix)
Heeler Pei - (Australian Cattle Dog x Chinese Shar-Pei mix)
Highland Maltie - (West Highland White Terrier (Westie) x Maltese mix)
Hovie Gold Retriever - (Hovawart x Golden Retriever mix)
Hug - (Siberian Husky x Pug mix)
Hush Basset - (Basset Hound x Cocker Spaniel mix)
Husker - (Boxer x Siberian Husky mix)
Huskimo - (Siberian Husky x American Eskimo mix)
Huskita - (Siberian Husky x Akita mix)
Husky Jack - (Siberian Husky x Jack Russell Terrier mix)
Husky Wheaten - (Siberian Husky x Soft Coated Wheaten Terrier mix)
A | B | C | D | E | F | G | H | I | J | K | L | M | N | O | P-Q | R | S | T | U-V | W | X-Y-Z
Imo-Inu - (American Eskimo x Shiba Inu mix)
Irish Afghan Setter - (Irish Setter x Afghan Hound mix)
Irish Bostetter - (Irish Setter x Boston Terrier mix)
Irish Boston Terrier - (Irish Terrier x Boston Terrier mix)
Irish Dane - (Irish Wolfhound x Great Dane mix)
Irish Dobe Setter - (Irish Setter x Doberman Pinscher mix)
Irish Doodle - (Irish Setter x Poodle mix)
Irish Jack Terrier - (Irish Terrier x Jack Russell Terrier mix)
Irish Lakeland Terrier - (Irish Terrier x Lakeland Terrier mix)
Irish Mastiff - (Irish Wolfhound x Mastiff mix)
Irish Russian Spanterrier - (Irish Water Spaniel x Black Russian Terrier  mix)
Irish Troodle - (Irish Terrier x Poodle mix)
Irish Wolf Greyhound - (Irish Wolfhound x Greyhound mix)
Irish Wolfoodle - (Irish Wolfhound x Poodle mix)
Irish Wolf Schnauzer - (Giant Schnauzer x Irish Wolfhound mix)
Irish Wolfsky - (Irish Wolfhound x Siberian Husky mix)
Italian Greycrested - (Italian Greyhound x Chinese Crested mix)
Italian Greyenji - (Italian Greyhound x Basenji mix)
Italian-Bichon - (Bichon Frise x Italian Greyhound mix)
Italian Border Greyollie - (Border Collie x Italian Greyhound mix)
Italian Bulldogge - (Neapolitan Mastiff x Olde English Bulldogge mix)
Italian Cairn - (Cairn Terrier x Italian Greyhound mix)
Italian Cavalier Greyhound  - (Italian Greyhound x Cavalier King Charles Spaniel mix)
Italian Daniff - (Cane Corso Italiano x Great Dane mix)
Italian Doxie - (Italian Greyhound x Dachshund mix)
Italian Eskimo - (Italian Greyhound x American Eskimo Dog mix)
Italian Greagle - (Italian Greyhound x Beagle mix)
Italian Grey Min Pin - (Italian Greyhound x Miniature Pinscher mix)
Italian Greyhuahua - (Chihuahua x Italian Greyhound mix)
Italian Mastweiler - (Italian Mastiff x Rottweiler mix)
Italian Papihound - (Italian Greyhound x Papillon mix)
Irish Saint Terrier - (Irish Terrier x Saint Bernard mix)
Italian Tzu - (Italian Greyhound x Shih Tzu mix)
Italian Whippet Greyhound - (Whippet x Italian Greyhound mix)
A | B | C | D | E | F | G | H | I | J | K | L | M | N | O | P-Q | R | S | T | U-V | W | X-Y-Z
Ja-Chon - (Bichon Frise x Japanese Chin mix)
Jacairn - (Cairn Terrier x Jack Russell Terrier mix)
Jack-A-Bee - (Beagle x Jack Russell Terrier mix)
Jack-A-Poo - (Jack Russell Terrier x Poodle mix)
Jack-A-Ranian - (Jack Russell Terrier x Pomeranian mix)
Jack Chi - (Chihuahua x Jack Russell Terrier mix)
Jack Highland Terrier  - (Jack Russell Terrier x West Highland White Terrier mix)
Jack Pit = (Jack Russell Terrier x Pit Bull Terrier mix)
Jack-Rat Terrier - (Jack Russell Terrier x Rat Terrier mix)
Jack Russell Greyhound - (Jack Russell Terrier x Greyhound mix)
Jack Tzu - (Jack Russell Terrier x Shih Tzu mix)
Jackie-Bichon - (Bichon Frise x Jack Russell Terrier mix)
Jackshund - (Jack Russell Terrier x Dachshund mix)
Jackweiler - (Jack Russell Terrier x Rottweiler mix)
Jafox - (Japanese Chin x Toy Fox Terrier mix)
Jaland - (Japanese Chin x West Highland White Terrier mix)
Japanese Chow Spitz - (Japanese Spitz x Chow Chow mix)
Japanese Spitz Chi - (Japanese Spitz x Chihuahua mix)
Japanese Thai Ridgespitz - (Japanese Spitz x Thai Ridgeback mix)
Japeke - (Japanese Chin x Pekinese mix)
Japillon - (Japanese Chin x Papillon mix)
Japug - (Japanese Chin x Pug mix)
Jarkie - (Japanese Chin x Yorkshire Terrier mix)
Jatese - (Japanese Chin x Maltese mix)
Jatzu - (Japanese Chin x Shih Tzu mix)
Jug - (Jack Russell x Pug mix)
Kashon - (Bichon Frise x Cairn Terrier mix)
Kelpie Corgi - (Australian Kelpie x Corgi mix)
Kelpie Heeler - (Australian Kelpie x Australian Cattle Dog mix)
Kelpie Lab - (Australian Kelpie x Labrador Retriever mix)
Kelpie Shepherd - (Australian Kelpie x German Shepherd mix)
Kelpie Staff - (Australian Kelpie x American Staffordshire Terrier mix)
Kerry Blue Schnauzer - (Kerry Blue Terrier x Schnauzer mix)
Kerrblushcnauz - (Kerry Blue Terrier x Miniature Schnauzer mix)
Kerry Wheaten - (Kerry Blue Terrier x Soft-Coated Wheaten mix)
Kimola - (American Eskimo x Lhasa Apso mix)
King Cavrin - (Cavalier King Charles x Cairn Terrier mix)
King Charles Yorkie - (Cavalier King Charles Spaniel x Yorkshire Terrier mix)
King Pin - (Cavalier King Charles Spaniel x Miniature Pinscher mix)
King Rat - (Cavalier King Charles x Rat Terrier mix)
King Schnauzer - (Cavalier King Charles Spaniel x Miniature Schnauzer mix)
King Wheaten - (Cavalier King Charles Spaniel x Soft Coated Wheaten Terrier mix)
Kobetan - (Cocker Spaniel x Tibetan Terrier mix)
Lab'Aire - (Airedale Terrier x Labrador Retriever mix)
Lab Apso - (Labrador Retriever x Lhasa Apso mix)
Lab Pei - (Labrador Retriever x Shar Pei mix)
Lab-Pointer - (Labrador Retriever x Pointer mix)
Labahoula - (Labrador Retriever x Louisiana Catahoula Leopard Dog mix)
Labany - (Labrador Retriever x Brittany Spaniel mix)
Labbe - (Beagle x Labrador Retriever mix)
Labernard - (Labrador Retriever x Saint Bernard mix)
Labernese - (Labrador x Bernese Mountain Dog mix)
Labloodhound - (Bloodhound x Labrador Retriever mix)
Labmaraner - (Labrador Retriever x Weimaraner mix)
Labollie - (Labrador Retriever x Collie mix)
Labrabull - (Labrador Retriever x American Pit Bull Terrier mix)
Labradane - (Labrador Retriever x Great Dane mix)
Labradinger - (English Springer Spaniel x Lab mix)
Labradoodle - (Labrador Retriever x Poodle mix)
Labradoodle Miniature - (Labrador Retriever x Toy or Miniature Poodle mix)
Labrador Corso - (Labrador Retriever x Cane Corso Italiano mix)
Labraheeler - (Labrador Retriever x Australian Cattle Dog mix)
Labrahuahua - (Labrador Retriever x Chihuahua mix)
Labrakita - (Labrador Retriever x Akita mix)
Labralas - (Labrador Retriever x Vizsla mix)
Labrasenji - (Labrador Retriever x Basenji  mix)
Labrastaff - (Labrador Retriever x American Staffordshire Terrier mix)
Labrottie - (Labrador Retriever x Rottweiler mix)
La-Chon - (Bichon Frise x Lhasa Apso mix)
Lacasapoo - (Cock-A-Poo x Lhasa Apso mix)
La Pom -(Pomeranian x Lhasa Apso mix)
LeoBerner - (Leonberger x Bernese Mountain Dog mix)
Lha-Basset - (Basset Hound x Lhasa Apso mix)
Lha-Cocker - (Cocker Spaniel x Lhasa Apso mix)
Lhasa-Corgi - (Corgi x Lhasa Apso mix)
Lhasa-Coton - (Coton de Tulear x Lhasa Apso mix)
Lhasa Jack - (Lhasa Apso x Jack Russell Terrier mix)
Lhasa Pin - (Lhasa Apso x Miniature Pinscher mix)
Lhasa Vendeen - (Lhasa Apso x Petit Basset Griffon Vendeen mix)
Lhaffon - (Brussels Griffon x Lhasa Apso mix)
Lhasalier - (Cavalier King Charles x Lhasa Apso mix)
Lhasanese - (Lhasa Apso x Pekingese mix)
Lhasapoo - (Lhasa Apso x Poodle mix)
Lhatese - (Lhasa Apso x Maltese mix)
A | B | C | D | E | F | G | H | I | J | K | L | M | N | O | P-Q | R | S | T | U-V | W | X-Y-Z
Malamute Pei - (Alaskan Malamute x Shar Pei mix)
Mal-Shi - (Maltese x Shih Tzu mix)
Malanees - (Alaskan Malamute x Great Pyrenees mix) 
Malchi - (Chihuahua x Maltese mix)
Mali-dutchie - (Belgian Malinois x Dutch Shepherd mix)
Malinois Akita - (Belgian Malinois x Akita mix)
Malinois Greyhound - (Belgian Malinois x Greyhound mix)
Malinois Mastiff - (Belgian Malinois x Mastiff mix)
Malinois X - (Belgian Malinois x German Shepherd Dog mix)
Mally Foxhound - (Alaskan Malamute x Foxhound mix)
Malteagle - (Beagle x Maltese mix)
Malti-Pin - (Maltese x Miniature Pinscher mix)
Malti-Poo - (Maltese x Poodle mix)
Malti-Pug - (Maltese x Pug mix)
Malti-Py - (Maltese x Great Pyrenees mix)
Maltichon - (Maltese x Bichon mix)
Maltipom - (Maltese x Pomeranian mix)
Malton - (Cavachon x Maltese mix)
Maremma Kelpie - (Maremma Sheepdog x Australian Kelpie mix)
Maremma Shepherd - (Maremma Sheepdog x German Shepherd mix)
Maspyr - (Mastiff x Great Pyrenees mix)
Mastador - (Mastiff x Labrador Retriever mix)
Mastapeake - (Mastiff x Chesapeake Bay Retriever mix)
Masti-Bull - (Mastiff x Bulldog mix)
Mastidoodle - (Mastiff x Poodle mix)
Mastiff Shepherd - (Mastiff x German Shepherd mix)
Mauxie - (Dachshund x Maltese mix)
Mauzer - (Maltese x Miniature Schnauzer mix)
Meagle - (Beagle x Miniature Pinscher mix)
Mi-kitese - (Maltese x Mi-Ki mix)
Mi-orkie - (Mi-Ki x Yorkshire Terrier mix)
Min Pin Frise - (Bichon Frise x Miniature Pinscher mix)
Min Pin Shepherd - (Miniature Pinscher x German Shepherd mix)
Mini Australian Shepterrier - (Australian Terrier x Miniature Australian Shepherd mix)
Mini Bolonauzer - (Bolognese x Miniature Schnauzer mix)
Mini Cairn Pin - (Cairn Terrier x Miniature Pinscher mix)
Mini Chisoxy - (Mini Fox Terrier x Chihuahua mix)
Mini English Cocker - (Dachshund x English Cocker Spaniel mix)
Mini Fo-Chon - (Bichon Frise x Mini Fox Terrier mix)
Mini Fo-Tzu - (Shih Tzu x Mini Fox Terrier mix)
Mini Foodle - (Poodle x Mini Fox Terrier mix)
Mini Fox Beagle - (Mini Fox Terrier x Beagle mix)
Mini Fox Pinscher - (Miniature Pinscher x Mini Fox Terrier mix)
Mini Foxie Doxie - (Mini Fox Terrier x Dachshund mix)
Mini Foxillon - (Miniature Fox Terrier x Papillon mix)
Mini Foxingese - (Pekingese x Mini Fox Terrier mix)
Mini Foxker - (Cocker Spaniel x Mini Fox Terrier mix)
Mini Foxton - (Boston Terrier x Mini Fox Terrier mix)
Mini Foxy Rat Terrier - (American Rat Terrier x Mini Fox Terrier mix)
Mini Foxy Russell - (Jack Russell Terrier x Mini Fox Terrier mix)
Mini Jafox - (Japanese Chin x Mini Fox Terrier mix)
Mini Kerry Blue Schnauzer - (Kerry Blue Terrier x Miniature Schnauzer mix)
Mini King Schnauzer - (Cavalier King Charles Spaniel x Miniature Schnauzer mix)
Mini Poxer - (Pug x Mini Fox Terrier mix)
Mini Ratzer - (Miniature Schnauzer x Rat Terrier mix)
Mini Schnauzer Chin - (Japanese Chin x Miniature Schnauzer mix)
Mini Schnauzer Jack - (Miniature Schnauzer x Jack Russell Terrier mix)
Mini Scottish Fox Terrier - (Scottish Terrier x Mini Fox Terrier mix)
Mini St. Bernard - (Saint Bernard x Cocker Spaniel mix)
Mini Texas Heeler - (Miniature Australian Shepherd x Australian Cattle Dog mix)
Mini Torkie - (Mini Fox Terrier x Yorkie mix)
Mini Toy Foxter - (Mini Fox Terrier x Toy Fox Terrier mix)
Mini Wire Hair Snauzer - (Miniature Schnauzer x Wire Fox Terrier mix)
Mini Yorkshire Aussie - (Miniature Australian Shepherd x Yorkshire Terrier mix)
Miniature Ausseippet - (Whippet x Miniature Australian Shepherd mix)
Miniature Aussiedoodle - (Miniature Australian Shepherd x Miniature Poodle mix)
Miniature Border Schnollie - (Border Collie x Miniature Schnauzer mix)
Miniature Boxer - (Boston Terrier x Boxer mix)
Miniature Bulldog - (Bulldog x Pug mix)
Miniature English Bulldach - (Bulldog x Dachshund mix)
Miniature French Bull Terrier - (French Bulldog x Miniature Bull Terrier mix)
Miniature French Schnauzer - (French Bulldog x Miniature Schnauzer mix)
Miniature Golden Retriever - (Golden Retriever x Cocker Spaniel x Poodle mix)
Miniature Goldendoodle - (Golden Retriever x Toy or Miniature Poodle mix)
Miniature Gordondoodle - (Gordon Setter x Miniature Poodle mix)
Miniature Irish Wolf Schnauzer - (Miniature Schnauzer x Irish Wolfhound mix)
Miniature Labradoodle - (Labrador Retriever x Toy or Miniature Poodle mix)
Miniature Pinschelkhound - (Miniature Pinscher x Norwegian Elkhound mix)
Miniature Schnaupin - (Miniature Schnauzer x Min Pin mix)
Miniature Schnauzzie - (Miniature Schnauzer x Miniature Australian Shepherd mix)
Miniature Schnoxie - (Dachshund x Miniature Schnauzer mix)
Miniboz - (Boston Terrier x Miniature Schnauzer mix)
MiniCoonhound - (Exact mix in this type of dog has not be disclosed)
Minnie Jack - (Jack Russell Terrier x Miniature Pinscher mix)
Minnie Parson - (Parson Russell Terrier x Miniature Pinscher mix)
Morkie - (Maltese x Yorkshire Terrier mix)
Morkshire Terrier - (Maltese x Biewer Terrier mix)
Mountain Bulldog - (Bernese Mountain Dog x Bulldog mix)
Mountain Cur Shepherd - (Mountain Cur x German Shepherd mix)
Mountain Jack Cur - (Mountain Cur x Jack Russell Terrier mix)
Mountain Mastiff - (Bernese Mountain Dog x Mastiff mix)
Muggin - (Miniature Pinscher x Pug mix)
Muscle Mastiff - (Dogue de Bordeaux x Mastiff mix)
A | B | C | D | E | F | G | H | I | J | K | L | M | N | O | P-Q | R | S | T | U-V | W | X-Y-Z
Native American Newfie - (Native American Indian Dog x Newfoundland mix)
Native American Shepherd - (Native American Indian Dog x Belgium Shepherd mix)
Native American Village Dog - (Native American Indian Dog x German Shepherd mix)
Neahond - (Neapolitan Mastiff x Keeshond mix)
Neapolitan Shepherd - (Neapolitan Mastiff x German Shepherd mix)
Neapolitan Boxer - (Neapolitan Mastiff x Boxer mix)
Nekita - (Akita x Neapolitan Mastiff mix)
Neo Bullmastiff - (Bullmastiff x Neapolitan Mastiff mix)
Neo Daniff - (Neapolitan Mastiff x Great Dane mix)
New Labralound - (Newfoundland x Labrador Retriever mix)
New Rottland - (Newfoundland x Rottweiler mix)
New Shep - (Newfoundland x German Shepherd Dog mix)
Newfie Dane - (Newfoundland x Great Dane mix)
Newfypoo - (Newfoundland x Poodle mix)
Norjack - (Norfolk Terrier x Jack Russell Terrier mix)
Nortese - (Norwich Terrier x Maltese x mix)
Norwich de Tulear - (Coton de Tulear x Norwich Terrier mix)
A | B | C | D | E | F | G | H | I | J | K | L | M | N | O | P-Q | R | S | T | U-V | W | X-Y-Z
Old Anglican Bulldogge - (American Pit Bull Terrier or American Staffordshire Terrier x Bulldog mix)
Old Deerhound Sheepdog - (Old English Sheepdog x Scottish Deerhound mix)
Old Doxie Sheepdog - (Dachshund x Old English Sheepdog mix)
Olde Boston Bullchi - (Olde Boston Bulldogge x Chihuahua mix)
Olde Double Bully - (Bulldog x Olde English Bulldogge mix)
Olde Pit Bulldogge - (American Pit Bull Terrier x Olde English Bulldogge mix)
Olde Staff Bulldogge - (American Staffordshire Terrier x Olde English Bulldogge mix)
Olde Staffybull Bulldogge - (Staffordshire Bull Terrier x Olde English Bulldogge mix)
Ori Pei - (Pug x Shar-Pei mix)
A | B | C | D | E | F | G | H | I | J | K | L | M | N | O | P-Q | R | S | T | U-V | W | X-Y-Z
Papastzu - (Papillon x Shih Tzu mix)
Papeagle - (Papillon x Beagle mix)
Paperanian - (Papillon x Pomeranian mix)
Papi-Inu - (Papillon x Shiba Inu mix)
Papi-poo - (Papillon x Poodle mix)
Papichon - (Papillon x Bichon mix)
Papigriffon - (Brussels Griffon x Papillon mix)
Papijack - (Papillon x Jack Russell Terrier mix)
Papimo - (American Eskimo x Papillon mix)
Papiox - (Papillon x Toy Fox Terrier mix)
Papitese - (Maltese x Papillon mix)
Papshund - (Dachshund x Papillon mix)
Parsonhund - (Parson Russell Terrier x Dachshund mix)
Patterdale Doxie - (Patterdale Terrier x Dachshund mix)
Patterdale Shepherd - (Patterdale Terrier x German Shepherd mix)
Patterbea - (Beagle x Patterdale Terrier mix)
Patterjack - (Patterdale Terrier x Jack Russell mix)
Patterland - (Patterdale Terrier x Lakeland Terrier mix)
Patton Terrier - (Patterdale Terrier x Boston Terrier mix)
Peagle - (Beagle x Pekingese mix)
Peek-A-Pom - (Pekingese x Pomeranian mix)
Pek-A-Rat - (Pekingese x Rat Terrier mix)
Pekalier - (Cavalier King Charles x Pekingese mix)
Pekarin - (Cairn Terrier x Pekingese mix)
Peke-A-Boo - (Bolognese x Pekingese mix)
Peke-A-Chon - (Bichon Frise x Pekingese mix)
Peke-A-Chow - (Pekingese x Chow Chow mix)
Peke-A-Jack - (Pekingese x Jack Russell Terrier mix)
Peke-A-Pap - (Papillon x Pekingese mix)
Peke-A-Pin - (Miniature Pinscher x Pekingese mix)
Peke-A-Tese - (Maltese x Pekingese mix)
Peka-A-West - (Pekingnese x West Highland White Terrier mix)
Peke-Italian - (Pekingnese x Italian Greyhound mix)
Pekehund - (Pekingese x Dachshund mix)
Pekepoo - (Pekingese x Poodle mix)
Pembroke Cocker Corgi - (Pembroke Welsh Corgi x American Cocker Spaniel mix)
Pembroke Corgi Pointer - (Pembroke Welsh Corgi x Pointer mix)
Pembroke Corman Shepherd - (Pembroke Welsh Corgi x German Shepherd mix)
Pembroke Corswiss - (Pembroke Welsh Corgi x Greater Swiss Mountain Dog mix)
Pembroke Sheltie - (Shetland Sheepdog x Pembroke Welsh Corgi mix)
Petite Goldendoodle - (Golden Retriever x Cocker Spaniel x Poodle mix)
Petite Golden Retriever - (Cavalier King Charles Spaniel with x Golden Retriever mix)
Petite Labradoodle - (Labrador Retriever x Cocker Spaniel x Poodle mix)
Pharaoh Lab - (Pharaoh Hound x Labrador Retriever mix)
Plica - (Basset Hound x Ori Pei mix)
Plotkita - (Plott Hound x Akita mix)
Plottahoula - (Plott Hound x Louisiana Catahoula Leopard Dog mix)
Plott Rottie - (Plott Hound x Rottweiler mix)
Plott Walker - (Plott Hound x Treeing Walker Coonhound mix)
Plush Danois - (Anatolian Shepherd Dog x Great Dane mix)
Pin-Tzu - (Miniature Pinscher x Shih Tzu mix)
Pineranian - (Miniature Pinscher x Pomeranian mix)
Pinny-Poo - (Miniature Pinscher x Poodle mix)
Pinweiler - (Miniature Pinscher x Rottweiler mix)
Pit Boodle - (Pit Bull x Poodle mix)
Pit Bullmastiff - (American Pit Bull Terrier x Bullmastiff mix)
Pit Heeler - (American Pitbull Terrier x Blue Heeler mix)
Pit Pei - (American Pit Bull Terrier x Shar-Pei mix)
Pit Pin - (American Pit Bull Terrier x Miniature Pinscher mix)
Pitchow - (American Pitbull Terrier x Chow Chow mix)
Pitsky - (American Pitbull Terrier x Siberian Husky or Alaskan Husky mix)
Pitweiler - (American Pit Bull Terrier x Rottweiler mix)
Pocket Pitbull - (American Pit Bull Terrier x Patterdale Terrier mix)
Pointer Bay - (German Shorthaired Pointer x Chesapeake Bay Retriever mix)
Pointer Pit - (American Pit Bull Terrier x Pointer mix)
Pointollie - (Pointer x Collie mix)
Pom-Kee - (Pomeranian x Keeshond mix)
Pom-A-Nauze - (Miniature Schnauzer x Pomeranian mix)
Pom-A-Pug - (Pomeranian x Pug mix)
Pom-Coton - (Coton De Tulear x Pomeranian mix)
Pom-Shi - (Pomeranian x Shiba Inu mix)
Pom-Silk - (Pomeranian x Silky Terrier mix)
Pom Terrier - (Pomeranian x Toy Fox Terrier mix)
Pomapoo - (Pomeranian x Poodle mix)
Pomchi - (Pomeranian x Chihuahua mix)
Pomeagle - (Beagle x Pomeranian mix)
Pomerat - (Pomeranian x American Rat Terrier mix)
Pomimo - (American Eskimo x Pomeranian mix)
Pomsky - (Pomeranian x Husky mix)
Pomston - (Boston Terrier x Pomeranian mix)
Poo-Shi - (Poodle x Shiba Inu mix)
Poo-Ton - (Coton De Tulear x Poodle mix)
Pooahoula - (Catahoula Leopard Dog x Poodle mix)
Poochin - (Japanese Chin x Poodle mix)
Pooda Houla - (Catahoula x Poodle mix)
Poogle - (Beagle x Poodle mix)
Poolky - (Poodle x Silky Terrier mix)
Pootalian - (Italian Greyhound x Poodle mix)
Poovanese - (Havanese x Poodle mix)
Poshies - (Pomeranian x Shetland Sheepdog mix)
Powderpap - (Papillon x Chinese Crested mix)
Presa Bulldog - (English Bulldog x Presa Canario mix)
Presa Dane - (Presa Canario x Great Dane mix)
Pug-A-Mo - (Pug x American Eskimo Dog mix)
Pug-Coton - (Pug x Coton de Tulear mix)
Pug Pit - (Pug x Pit Bull Terrier mix)
Pug Shiba - (Pug x Shiba Inu mix)
Pug-Zu - (Pug x Shih Tzu mix)
Pugador - (Pug x Labrador Retriever mix)
Pugairn - (Pug x Cairn Terrier mix)
Pugalier - (Cavalier King Charles Spaniel x Pug mix)
Puganese - (Pug x Havanese mix)
Pugapoo - (Pug x Poodle mix)
Pugese - (Pug x Chinese Crested mix)
Puggat - (Pug x American Rat Terrier mix)
Puggit - (Pug x Italian Greyhound mix)
Puggle - (Pug x Beagle mix)
Pughasa - (Pug x Lhasa Apso mix)
Pugillon - (Pug x Papillon mix)
Puginese - (Pug x Pekingese mix)
Pugland - (Pug x Westie mix)
Pugottie - (Pug x Scottish Terrier mix)
Pugmatian - (Pug x Dalmatian mix)
Pugshire - (Pug x Yorkshire Terrier mix)
Pugwich - (Pug x Norwich Terrier mix)
Pushon - (Pug x Bichon Frise mix)
Pyredoodle - (Great Pyrenees x Poodle mix)
Pyrenees Husky - (Great Pyrenees x Siberian Husky mix)
Pyrenees Pit - (Great Pyrenees x American Pit Bull Terrier mix)
Pyrador - (Great Pyrenees x Labrador Retriever mix)
A | B | C | D | E | F | G | H | I | J | K | L | M | N | O | P-Q | R | S | T | U-V | W | X-Y-Z
Raggle - (American Rat Terrier x Beagle mix)
Rashon - (Rat Terrier x Bichon Frise mix)
Rat-A-Pap - (American Rat Terrier x Papillon mix)
Rat Apso - (Lhasa Apso x Rat Terrier mix)
Rat Basset - (Basset Hound x Rat Terrier mix)
Rat-Cha - (Rat Terrier x Chihuahua mix)
Rat Feist - (Rat Terrier x Mountain Feist mix)
Rat Heeler - (Rat Terrier x Australian Cattle Dog mix)
Rat Pei - (Rat Terrier x Shar Pei mix)
Rat Pinscher - (Rat Terrier x Miniature Pinscher mix)
Ratahoula - (Rat Terrier x Catahoula Leopard Dog mix)
Ratese - (American Rat Terrier x Maltese mix)
Ratshi Terrier - (American Rat Terrier x Shih Tzu mix)
Ratshire Terrier - (Yorkshire Terrier x American Rat Terrier mix)
Rattle - (American Rat Terrier x Poodle mix)
Rattle Griffon - (Brussels Griffon x Rat Terrier mix)
Reagle - (Rottweiler x Beagle mix)
Redbone Coonoodle - (Redbone Coonhound x Poodle mix)
Redbone Lab - (Redbone Coonhound x Labrador Retriever mix)
Redbone Shepherd - (Redbone Coonhound x German Shepherd mix)
Rhodesian Beagle - (Rhodesian Ridgeback x Beagle mix)
Rhodesian Bernard - (Rhodesian Ridgeback x Saint Bernard mix)
Rhodesian Boxer - (Rhodesian Ridgeback x Boxer mix)
Rhodesian Labrador - (Rhodesian Ridgeback x Labrador Retriever mix)
Rhodesian Pit - (Rhodesian Ridgeback x Pit Bull Terrier mix)
Rhodesian Rottie - (Rhodesian Ridgeback x Rottweiler mix)
Rhodesian Shepherd - (Rhodesian Ridgeback x German Shepherd mix)
Rhodesian Whippet - (Rhodesian Ridgeback x Whippet mix)
Rott Pei - (Rottweiler x Shar Pei mix)
Rottaf - (Afghan Hound x Rottweiler mix)
Rottbull - (Rottweiler x Bull Terrier mix)
Rotterman - (Doberman Pinscher x Rottweiler mix)
Rotticorso - (Rottweiler x Cane Corso Italiano mix)
Rottie Basset - (Rottweiler x Basset Hound mix)
Rottie Bordeaux - (Dogue de Bordeaux x Rottweiler mix)
Rottie Chow - (Rottweiler x Chow Chow mix)
Rottie Cocker - (Rottweiler x Cocker Spaniel mix)
Rottie Corgi - (Rottweiler x Corgi mix)
Rottie Heeler - (Rottweiler x Australian Cattle Dog mix)
Rottie Shepherd - (Rottweiler x German Shepherd mix)
Rottle - (Rottweiler x Poodle mix)
Rottmatian - (Rottweiler x Dalmatian mix)
Rottpeake - (Rottweiler x Chesapeake Bay Retriever mix)
Rottsky - (Rottweiler x Siberian Husky mix)
Rough Rhodesian Collie - (Rough Collie x Rhodesian Ridgeback mix)
Rus-A-Pei - (Jack Russell Terrier x Chinese Shar Pei mix)
Russian Doodle Terrier - (Black Russian Terrier x Poodle mix)
Rustralian Terrier - (Australian Terrier x Jack Russell Terrier mix)
A | B | C | D | E | F | G | H | I | J | K | L | M | N | O | P-Q | R | S | T | U-V | W | X-Y-Z
Saint Bernese - (Saint Bernard x Bernese Mountain Dog mix)
Saint Berdoodle - (Saint Bernard x Poodle mix)
Saint Bermastiff - (Mastiff x Saint Bernard mix)
Saint Bernewfie - (Saint Bernard x Newfoundland mix)
Saint Berxer - (Saint Bernard x Boxer mix)
Saint Chesa Bay Bernard - (Saint Bernard x Chesapeake Bay Retriever mix)
Saint Dane - (Great Dane x Saint Bernard mix)
Saint Pyrenees - (Saint Bernard x Great Pyrenees mix)
Saint Shepherd - (Saint Bernard x German Shepherd mix)
Saluki Greyhound - (Saluki x Greyhound mix)
Saluki Deerhound - (Saluki x Scottish Deerhound mix)
Saluki Sloughi - (Saluki x Sloughi mix)
Sammy Chow - (Samoyed x Chow Chow mix)
Sammy Shepherd - (Samoyed x German Shepherd mix)
Sammypoo - (Samoyed x Poodle mix)
Samollie - (Samoyed x Collie mix)
Samusky - (Samoyed x Husky mix)
Sceagle - (Beagle x Scottish Terrier mix)
Schapso - (Lhasa Apso x Miniature Schnauzer mix)
Schip-A-Pom - (Pomeranian x Schipperke mix)
Schip Coton - (Schipperke x Coton de Tulear mix)
Schipese - (Maltese x Schipperke mix)
Schipper-Chi - (Schipperke x Chihuahua mix)
Schipper Geraussie Shepherd - (Schipperke x German Shepherd x Australian Shepherd mix)
Schipper-Pin - (Schipperke x Miniature Pinscher mix)
Schipper-Poo - (Poodle x Schipperke mix)
Schnairedale - (Airedale Terrier x Schnauzer mix)
Schnau-Tzu - (Miniature Schnauzer x Shih Tzu mix)
Schnauffen - (Schnauzer x Affenpinscher mix)
Schnauzador = (Schnauzer x Labrador Retriever mix)
Schnauzer Pit = (Schnauzer x Pit Bull mix)
Schneagle - (Beagle x Schnauzer mix)
Schnekingese - (Miniature Schnauzer x Pekingese mix)
Schnese - (Havanese x Miniature Schnauzer mix)
Schnocker - (Miniature Schnauzer x Cocker Spaniel mix)
Schnoodle - (Schnauzer x Poodle mix)
Schnorgi - (Schnauzer x Corgi mix)
Schnottie - (Schnauzer x Rottweiler mix)
Schnu - (Miniature Schnauzer x Shiba Inu mix)
Schnug - (Miniature Schnauzer x Pug mix)
Schweenie - (Dachshund x Shih Tzu mix)
Sco-Shi - (Scottish Terrier x Shih Tzu mix)
Scobo Terrier - (Boston Terrier x Scottish Terrier mix)
Scoland Terrier - (Scottish Terrier x Westie mix)
Scolden Terrier - (Scottish Terrier x Golden Retriever mix)
Scorkie - (Scottish Terrier x Yorkshire Terrier mix)
Scotchi - (Scottish Terrier x Chihuahua mix)
Scotchon - (Bichon Frise x Scottish Terrier mix)
Scotinese - (Pekingese x Scottish Terrier mix)
Scottese - (Maltese x Scottish Terrier mix)
Scotti Apso - (Lhasa Apso x Scottish Terrier mix)
Scottie Schnauzer - (Scottish Terrier x Schnauzer)
Scottish Cocker - (Cocker Spaniel x Scottish Terrier mix)
Scottish Deer Greyhound - (Greyhound x Scottish Deerhound mix)
Scottish-Skye Terrier - (Scottish Terrier x Skye Terrier mix)
Scottish Staffish Bull Terrier - (Scottish Terrier x Staffordshire Bull Terrier mix)
Scoodle - (Scottish Terrier x Poodle mix)
Sealydale Terrier - (Sealyham Terrier x Airedale Terrier mix)
Shairn-Inu - (Cairn Terrier x Shiba Inu mix)
Sharbo - (Boston Terrier x Chinese Shar-Pei mix)
Shar-Pei Pitbull Terrier - (Chinese Shar-Pei x American Pit Bull Terrier mix)
Shar-Poo - (Shar-Pei x Poodle mix)
Shar Tzu - (Shar-Pei x Shih Tzu mix)
Sharberian Husky - (Chinese Shar-pei x Siberian Husky mix)
Sharmatian - (Chinese Shar-Pei x Dalmatian mix)
Sharp Eagle - (Beagle x Chinese Shar Pei mix)
Sheepadoodle - (Old English Sheepdog x Standard Poodle mix)
Shel-Aussie - (Australian Shepherd or Miniature Australian Shepherd x Shetland Sheepdog mix)
Shelchon - (Bichon Frise x Shetland Sheepdog mix)
Shelestie - (Shetland Sheepdog x West Highland White Terrier mix)
Shelillon - (Papillon x Shetland Sheepdog mix)
Sheltidoodle - (Sheltie x Poodle mix)
Sheltie Heeler - (Shetland Sheepdog x Australian Cattle Dog (Heeler) mix)
Sheltie Inu - (Shetland Sheepdog x Shiba Inu mix)
Sheltie-Kee - (Keeshond x Shetland Sheepdog mix)
Sheltie Pin - (Shetland Sheepdog x Miniature Pinscher mix)
Sheltie Pug - (Shetland Sheepdog x Pug mix)
Sheltie Shepherd - (German Shepherd x Shetland Sheepdog mix)
Sheltie Tzu - (Shetland Sheepdog x Shih Tzu mix)
Shepadoodle - (German Shepherd x Standard Poodle mix)
Shepherd Pei - (German Shepherd x Shar Pei mix)
Shepherd Pit - (German Shepherd x American Pit Bull Terrier mix)
Shepherd Tzu - (German Shepherd x Shih Tzu mix)
Shepnees - (German Shepherd x Great Pyrenees mix)
Sheprador - (Australian Shepherd x Labrador Retriever mix)
Shepsky - (German Shepherd x Siberian Husky mix)
Sheptese - (German Shepherd x Maltese mix)
Shepweiler - (German Shepherd x Rottweiler mix)
Shethund - (Shetland Sheepdog x Dachshund mix)
Shetinese - (Pekingese x Shetland Sheepdog mix)
Shi-Beagle - (Beagle x Shiba Inu mix)
Shiba-Chi - (Chihuahua x Shiba Inu mix)
Shiba Corgi - (Shiba Inu x Welsh Corgi mix)
Shiba Lab - (Shiba Inu x Labrador Retriever mix)
Shiba Pin - (Shiba Inu x Miniature Pinscher mix)
Shibadox - (Shiba Inu x Dachshund mix)
Shibos - (Boston Terrier x Shiba Inu mix)
ShiChi - (Chihuahua x Shih Tzu mix)
Shichon - (Bichon Frise x Shih Tzu mix)
Shiffon - (Brussels Griffon x Shih Tzu mix)
Shih Apso - (Lhasa Apso x Shih Tzu mix)
Shih-Mo - (American Eskimo x Shih Tzu mix)
Shih-Poo - (Shih-Tzu x Poodle mix)
Shinese - (Shih Tzu x Pekingese mix)
Shiranian - (Pomeranian x Shih Tzu mix)
Shocker - (Cocker Spaniel x Shiba Inu mix)
Shockerd - (English Shepherd x Cocker Spaniel mix)
Shollie - (German Shepherd x Collie mix)
Shorgi - (Corgi x Shih-Tzu mix)
Shorkie Tzu - (Shih Tzu x Yorkie mix)
Shug - (German Shepherd Dog x Pug mix)
Sibercaan - (Siberian Husky or Native American Indian Dog x Canaan Dog mix)
Siberian Black Mouth Cur - (Black Mouth Cur x Siberian Husky mix) (picture needed)
Siberian Boston - (Siberian Husky x Boston Terrier mix)
Siberian Cocker - (Cocker Spaniel x Siberian Husky mix)
Siberian Collisky - (Siberian Husky x Collie mix)
Siberian Indian Dog - (Siberian Husky x Native American Indian Dog mix)
Siberian Keeshond - (Siberian Husky x Keeshond mix)
Siberian Kelpsky - (Siberian Husky x Australian Kelpie mix)
Siberian Pinscher - (Doberman Pinscher x Siberian Husky mix)
Siberian Retriever - (Siberian Husky x Labrador Retriever mix)
Siberian Shiba - (Siberian Husky x Shiba Inu mix)
Siberpoo - (Siberian Husky x Poodle mix)
Silkchon - (Bichon Frise x Silky Terrier mix)
Silkese - (Maltese x Silky Terrier mix)
Silkin - (Japanese Chin x Silky Terrier mix)
Silkinese - (Pekingese x Silky Terrier mix)
Silkland Terrier - (Silky Terrier x Westie mix)
Silkshire Terrier - (Silky Terrier x Yorkshire Terrier mix)
Silkshund - (Dachshund x Silky Terrier mix)
Silky Cairn - (Cairn Terrier x Silky Terrier mix)
Silky Cocker - (Maltese x Cocker Spaniel mix)
Silky Coton - (Coton de Tulear x Silky Terrier mix)
Silky Jack - (Jack Russell Terrier x Silky Terrier mix)
Silky-Lhasa - (Lhasa Apso x Silky Terrier mix)
Silky-Pin - (Miniature Pinscher x Silky Terrier mix)
Silky Pug - (Pug x Silky Terrier mix)
Silky Tzu - (Silky Terrier x Shih-Tzu mix)
Silkyhuahua - (Chihuahua x Silky Terrier mix)
Silkytie - (Shetland Sheepdog x Silky Terrier mix)
Silkzer - (Miniature Schnauzer x Silky Terrier mix)
Ski-Border - (American Eskimo x Border Collie mix)
Ski-Collie - (American Eskimo x Collie mix)
Skilky Terrier - (Scottish Terrier x Silky Terrier mix)
Skip-Shzu - (Schipperke x Shih Tzu mix)
Skye-Pap - (Skye Terrier x Papillon mix)
Skypoo - (Poodle x Skye Terrier mix)
Smooth Chisoxy - (Smooth Fox Terrier x Chihuahua mix)
Smooth Fo-Chon - (Bichon Frise x Smooth Fox Terrier mix)
Smooth Fo-Tzu - (Shih Tzu x Smooth Fox Terrier mix)
Smooth Foodle - (Poodle x Smooth Fox Terrier mix)
Smooth Fox Beagle - (Smooth Fox Terrier x Beagle mix)
Smooth Fox Pinscher - (Miniature Pinscher x Smooth Fox Terrier mix)
Smooth Foxie Doxie - (Smooth Fox Terrier x Dachshund mix)
Smooth Foxingese - (Pekingese x Smooth Fox Terrier mix)
Smooth Foxker - (Cocker Spaniel x Smooth Fox Terrier mix)
Smooth Foxillon - (Papillon x Smooth Fox Terrier mix)
Smooth Foxton - (Boston Terrier x Smooth Fox Terrier mix)
Smooth Foxy Boerboel - (Smooth Fox Terrier x Boerboel mix)
Smooth Foxy Rat Terrier - (American Rat Terrier x Smooth Fox Terrier mix)
Smooth Foxy Russell - (Jack Russell Terrier x Smooth Fox Terrier mix)
Smooth Foxybull Terrier - (Smooth Fox Terrier x Bulldog mix)
Smooth Jafox - (Japanese Chin x Smooth Fox Terrier mix)
Smooth Toy Foxter - (Toy Fox Terrier x Smooth Fox Terrier mix)
Smooth Pom Terrier - (Pomeranian x Smooth Fox Terrier mix)
Smooth Poxer - (Pug x Smooth Fox Terrier mix)
Smooth Rhodesian Collie - (Smooth Collie x Rhodesian Ridgeback mix)
Smooth Scottish Fox Terrier - (Scottish Terrier x Smooth Fox Terrier mix)
Smooth Torkie - (Smooth Fox Terrier x Yorkie mix)
Sniffon - (Miniature Schnauzer x Brussels Griffon mix)
Snorkie - (Miniature Schnauzer x Yorkshire Terrier mix)
Soft Coated Golden - (Golden Retriever x Soft Coated Wheaten mix)
Soft Coated Wheatzer - (Miniature Schnauzer x Soft Coated Wheaten Terrier mix)
Soft Coated Woxer - (Boxer x Soft Coated Wheaten mix)
Spanador - (Labrador Retriever x Cocker Spaniel mix)
Spangold Retriever - (English Springer Spaniel x Golden Retriever mix)
Spanierd - (English Springer Spaniel x German Shepherd Dog mix)
Spantriever - (English Cocker Spaniel x Labrador Retriever mix)
Spreagle - (English Springer Spaniel x Beagle mix)
Springer Basset - (English Springer Spaniel x Basset Hound mix)
Springer Husky - (English Springer Spaniel x Siberian Husky mix)
Springer Pit - (English Springer Spaniel x American Pit Bull Terrier mix)
Springer Rottie - (English Springer Spaniel x Rottweiler mix)
Springer Spaniel Sheepdog - (English Springer Spaniel x Old English Sheepdog mix)
Springerdoodle - (English Springer Spaniel x Poodle mix)
Sprocker Spaniel - (English Springer Spaniel x Cocker Spaniel mix)
Sprollie - (English Springer Spaniel x Collie mix)
Staffy Bull Bordeaux - (Staffordshire Bull Terrier x Dogue de Bordeaux mix)
Staffy Bull Bullmastiff - (Staffordshire Bull Terrier x Bullmastiff mix)
Staffweiler - (American Staffordshire Terrier x Rottweiler mix)
St. Weiler - (Rottweiler x Saint Bernard mix)
Staffie Bullweiler - (Staffordshire Bull Terrier x Rottweiler mix)
Staffy Bull Pei - (Staffordshire Bull Terrier x Shar Pei mix)
Staffy Bull Pit - (Staffordshire Bull Terrier x Pit Bull Terrier mix)
Staffy Bull Pug - (Staffordshire Bull Terrier x Pug mix)
Staffy Bull Wolfhound - (Staffordshire Bull Terrier x Irish Wolfhound mix)
Staffy Heeler - (American Staffordshire Terrier x Australian Cattle Dog mix)
Staffy Pit - (American Staffordshire Terrier x Pit Bull Terrier mix)
Standard Auss-Tzu - (Australian Shepherd x Shih Tzu mix)
Standard Bolonauzer - (Bolognese x Standard Schnauzer mix)
Standard Border Schnollie - (Border Collie x Standard Schnauzer mix)
Standard Chesa-Poo - (Chesapeake Bay Retriever x Standard Poodle mix)
Standard Gordondoodle - (Gordon Setter x Standard Poodle mix)
Standard Irish Wolf Schnauzer - (Standard Schnauzer x Irish Wolfhound mix)
Standard Kerry Blue Schnauzer - (Kerry Blue Terrier x Standard Schnauzer mix)
Standard Ratzer - (Standard Schnauzer x Rat Terrier mix)
Standard Schnauzer Chin - (Japanese Chin x Standard Schnauzer mix)
Standard Schnoodle - (Poodle x Standard Schnauzer mix)
Standard Siberian Schusky - (Standard Schnauzer x Siberian Husky mix)
Standard Wauzer - (Westie x Standard Schnauzer mix)
Standard Wire Hair Snauzer - (Standard Schnauzer x Wire Fox Terrier mix)
Stump Double Cattle Dog - (Australian Stumpy Tail Cattle Dog x Australian Cattle Dog mix)
Swiss Bernese Mt. Dog - (Bernese Mountain Dog x Greater Swiss Mountain Dog mix)
Swiss Newfie - (Greater Swiss Mountain Dog x Newfoundland mix)
Swissy Saint - (Greater Swiss Mountain Dog x Saint Bernard mix)
Swissneese - (Great Swiss Mountain Dog x Great Pyrenees mix)
A | B | C | D | E | F | G | H | I | J | K | L | M | N | O | P-Q | R | S | T | U-V | W | X-Y-Z
Taco Terrier - (Chihuahua x Toy Fox Terrier mix)
Taylor's Bulldane - (Old Tyme Bulldog x Great Dane mix)
Terri-Poo - (Australian Terrier x Poodle mix)
Tervard - (Belgian Tervuren x German Shepherd Dog mix)
Tervoodle - (Belgian Tervuren x Poodle mix)
Texas Heeler - (Australian Cattle Dog x Australian Shepherd Dog mix)
Thai Boxridge - (Thai Ridgeback x Boxer mix)
Tibalier - (Cavalier King Charles Spaniel x Tibetan Spaniel mix)
Tibecot - (Coton de Tulear x Tibetan Terrier mix)
Tibepillon Terrier - (Papillon x Tibetan Terrier mix)
Tibetan Chin - (Tibetan Spaniel x Japanese Chin mix)
Tibetan Golden Mastiff - (Tibetan Mastiff x Golden Retriever mix)
Tibetan Pap - (Tibetan Spaniel x Papillon mix)
Tibetan Pom - (Pomeranian x Tibetan Spaniel mix)
Tibetan Pug - (Pug x Tibetan Spaniel mix)
Tibetan Spaltese - (Maltese x Tibetan Spaniel mix)
Tibetan Wolfhound - (Tibetan Mastiff x Irish Wolfhound mix)
Tibetanpei Spaniel - (Tibetan Spaniel x Chinese Shar-Pei mix)
Tibetan Staffy Spaniel - (Tibetan Spaniel x American Staffordshire Terrier mix)
Toller Pit - (Nova Scotia Duck Tolling Retriever x Pit Bull Terrier mix)
Torkie - (Toy Fox Terrier x Yorkie mix)
Tosa-Pei - (Tosa x Shar Pei mix)
Toxirn - (Cairn Terrier x Chihuahua mix)
Toy Chisoxy - (Toy Fox Terrier x Chihuahua mix)
Toy Fo-Chon - (Bichon Frise x Toy Fox Terrier mix)
Toy Fo-Tzu - (Shih Tzu x Toy Fox Terrier mix)
Toy Foodle - (Poodle x Toy Fox Terrier mix)
Toy Fox Beagle - (Toy Fox Terrier x Beagle mix)
Toy Fox Pinscher - (Miniature Pinscher x Toy Fox Terrier mix)
Toy Foxie Doxie - (Toy Fox Terrier x Dachshund mix)
Toy Foxillon - (Papillon x Toy Fox Terrier mix)
Toy Foxingese - (Pekingese x Toy Fox Terrier mix)
Toy Foxker - (Cocker Spaniel x Toy Fox Terrier mix)
Toy Foxton - (Boston Terrier x Toy Fox Terrier mix)
Toy Foxy Rat Terrier - (American Rat Terrier x Toy Fox Terrier mix)
Toy Foxy Russell - (Jack Russell Terrier x Toy Fox Terrier mix)
Toy Foxybull Terrier - (Toy Fox Terrier x Bulldog mix)
Toy Gordondoodle - (Gordon Setter x Toy Poodle mix)
Toy Jafox - (Japanese Chin x Toy Fox Terrier mix)
Toy Pom Terrier - (Pomeranian x Toy Fox Terrier mix)
Toy Poxer - (Pug x Toy Fox Terrier mix)
Toy Rat Doxie - (Dachshund x American Rat Terrier mix)
Toy Scottish Fox Terrier - (Scottish Terrier x Toy Fox Terrier mix)
Toy Torkie - (Toy Fox Terrier x Yorkie mix)
Transylvizsla Hound - (Transylvanian Hound x Vizsla mix)
Treeing Walker Coonoodle - (Treeing Walker Coonhound x Poodle mix)
Tsvetnaya Blonka-Poo - (Poodle x Russian Tsvetnaya Bolonka mix)
Ttoodle - (Poodle x Tibetan Terrier mix)
Tzu Basset - (Basset Hound x Shih Tzu mix)
A | B | C | D | E | F | G | H | I | J | K | L | M | N | O | P-Q | R | S | T | U-V | W | X-Y-Z
Ultimate Mastiff - (Dogue de Bordeaux x Neapolitan Mastiff mix)
Vizmaraner - (Vizsla x Weimaraner mix)
Vizsla Pin - (Vizsla x Miniature Pinscher mix)
Vizsla Staff - (Vizsla x American Staffordshire Terrier mix)
A | B | C | D | E | F | G | H | I | J | K | L | M | N | O | P-Q | R | S | T | U-V | W | X-Y-Z
Walker Beagle - (Treeing Walker Coonhound x Beagle mix)
Walker Greyhound - (Treeing Walker Coonhound x Greyhound mix)
Wauzer - (Westie x Schnauzer mix)
Wee-Chon - (Westie x Bichon Frise mix)
Weeranian - (Westie x Pomeranian mix)
Weiler Dane - (Rottweiler x Great Dane mix)
Weim-Pei - (Weimaraner x Shar Pei mix)
Weimapeake - (Weimaraner x Chesapeake Bay Retriever mix)
Weimardale - (Weimaraner x Airdale Terrier mix)
Weimardoodle - (Weimaraner x Poodle mix)
Weimarman - (Weimaraner x Doberman Pinscher mix)
Weimarrott - (Weimaraner x Rottweiler mix)
Weimshepherd- (Weimaraner x German Shepherd mix)
Wel-Chon - (Bichon Frise x Welsh Terrier mix)
Welsh Mini Fox Terrier - (Welsh Terrier x Mini Fox Terrier mix)
Welsh Smooth Fox Terrier - (Welsh Terrier x Smooth Fox Terrier mix)
Welsh Toy Fox Terrier - (Welsh Terrier x Toy Fox Terrier mix)
Welsh Wire Fox Terrier - (Welsh Terrier x Wire Fox Terrier mix)
Welshund - (Welsh Terrier x Dachshund mix)
Weltador - (Labrador Retriever x Welsh Terrier mix)
Weshi - (Shih Tzu x Westie mix)
West Australian Terrier  - (Australian Terrier x West Highland White Terrier mix)
West Highland Corgi - (West Highland White Terrier (Westie) x Corgi mix)
West Highland Doxie - (Dachshund x West Highland White Terrier mix)
West Highland Husky - (Siberian Husky x West Highland White Terrier mix)
West of Argyll Terrier - (Beagle x West Highland White Terrier mix)
Westeke - (West Highland White Terrier x Schipperke mix)
Westie-Laso - (Lhasa Apso x West Highland White Terrier mix)
Westie Staff - (West Highland White Terrier x American Staffordshire Terrier mix)
Westiepoo - (Westie x Poodle mix)
Westillon - (Westie x Papillon mix)
Westimo - (American Eskimo x West Highland White Terrier mix)
Weston - (West Highland White Terrier x Coton de Tulear mix)
Wheagle - (Soft Coated Wheaten Terrier x Beagle mix)
Wheatador - (Soft Coated Wheaten Terrier x Labrador Retriever mix)
Wheaten Eskimo - (American Eskimo x Soft Coated Wheaten Terrier mix)
Wheaten Pei - (Soft Coated Wheaten Terrier x Shar Pei mix)
Whipador - (Whippet x Labrador Retriever mix)
Whipperman - (Whippet x Doberman Pinscher mix)
Whippet Greyhound - (Whippet x Greyhound mix)
Whippet Shepherd - (Whippet x German Shepherd mix)
Whoodle - (Soft Coated Wheaten Terrier x Poodle mix)
Wire Chisoxy - (Wire Fox Terrier x Chihuahua mix)
Wire Fo-Chon - (Bichon Frise x Wire Fox Terrier mix)
Wire Fo-Tzu - (Shih Tzu x Wire Fox Terrier mix)
Wire Foodle - (Poodle x Wire Fox Terrier mix)
Wire Fox Beagle - (Wire Fox Terrier x Beagle mix)
Wire Fox Pinscher - (Wire Fox Terrier x Miniature Pinscher mix)
Wire Foxie Doxie - (Wire Fox Terrier x Dachshund mix)
Wire Foxingese - (Pekingese x Wire Fox Terrier mix)
Wire Foxker - (Cocker Spaniel x Wire Fox Terrier mix)
Wire Foxton - (Boston Terrier x Wire Fox Terrier mix)
Wire Foxy Rat Terrier - (American Rat Terrier x Wire Fox Terrier mix)
Wire Foxy Russell - (Jack Russell Terrier x Wire Fox Terrier mix)
Wire Foxybull Terrier - (Wire Fox Terrier x Bulldog mix)
Wire Hair Snauzer - (Miniature Schnauzer x Wire Fox Terrier mix)
Wire Jafox - (Japanese Chin x Wire Fox Terrier mix)
Wire Toy Foxter - (Toy Fox Terrier x Wire Fox Terrier mix)
Wire Pom Terrier - (Pomeranian x Wire Fox Terrier mix)
Wire Poxer - (Pug x Wire Fox Terrier mix)
Wire-Poo - (Wirehaired Fox Terrier x Poodle mix)
Wire Scottish Fox Terrier - (Scottish Terrier x Wire Fox Terrier mix)
Wire Torkie - (Wire Fox Terrier x Yorkie mix)
Wirehaired Pointing Griffiondor - (Wirehaired Pointing Griffon  x Labrador Retriever mix)
Wirelsh Terrier - (Welsh Terrier x Wire Fox Terrier mix)
Wolador - (Timber Wolf x Labrador Retriever mix)
Wolamute - (Timber Wolf x Alaskan Malamute mix)
Wolfdog - (Wolf x Domestic Dog mix)
Wolfhound Dane - (Irish Wolfhound x Great Dane mix)
Woodle - (Welsh Terrier x Poodle mix)
Worgi - (Welsh Sheepdog x Corgi mix)
Wowauzer - (Miniature Schnauzer x Welsh Terrier mix)
Yoranian - (Pomeranian x Yorkshire Terrier mix)
Yorkeltie - (Yorkshire Terrier x Shetland Sheepdog (Sheltie) mix)
Yorkie-Apso - (Lhasa Apso x Yorkshire Terrier mix)
Yorkie Beagle - (Yorkshire Terrier x Beagle mix)
Yorkie Pin - (Miniature Pinscher x Yorkshire Terrier mix)
Yorkie Russell - (Yorkshire Terrier x Jack Russell Terrier mix)
Yorkie-ton - (Coton de Tulear x Yorkshire Terrier mix)
Yorkillon - (Papillon x Yorkshire Terrier mix)
Yorkipoo - (Yorkie x Poodle mix)
Yorkinese - (Pekingese x Yorkie mix)
Yorksky - (Siberian Husky x Yorkshire Terrier mix)
Yorktese - (Yorkshire Terrier x Maltese mix)
Yorwich - (Yorkshire Terrier x Norwich Terrier mix)
Zuchon - (Bichon Frise x Shih Tzu mix)