x1-how-did-jesus-do-it	Text/1 - How Did Jesus Do It.xhtml
x10-ongoing-personal-conflicts	Text/10 - Ongoing Personal Conflicts.xhtml
x11-what-are-demons	Text/11 - What Are Demons.xhtml
x12-flesh-or-demons	Text/12 - Flesh or Demons.xhtml
x13-how-do-demons-come-in	Text/13 - How Do Demons Come In.xhtml
x14-what-is-the-occult	Text/14 - What is the Occult.xhtml
x15-is-witchcraft-still-at-work-today	Text/15 - Is Witchcraft Still At Work Today.xhtml
x16-do-christians-ever-need-deliverance-from-demons	Text/16 - Do Christians Ever Need Deliverance From Demons.xhtml
x17-will-the-holy-spirit-indwell-an-unclean-vessel	Text/17 - Will the Holy Spirit Indwell an Unclean Vessel.xhtml
x18-characteristic-activities-of-demons	Text/18 - Characteristic Activities of Demons.xhtml
x19-areas-of-personality-affected-by-demons	Text/19 - Areas of Personality Affected by Demons.xhtml
x2-terminology	Text/2 - Terminology.xhtml
x20-demons-of-sickness-and-infirmity	Text/20 - Demons of Sickness and Infirmity.xhtml
x21-preparing-for-deliverance	Text/21 - Preparing For Deliverance.xhtml
x22-a-prayer-for-deliverance	Text/22 - A Prayer for Deliverance.xhtml
x23-how-to-keep-your-deliverance	Text/23 - How To Keep Your Deliverance.xhtml
x24-why-some-are-not-delivered	Text/24 - Why Some Are Not Delivered.xhtml
x25-helping-others-be-set-free	Text/25 - Helping Others Be Set Free.xhtml
x26-after-deliverance	Text/26 - After Deliverance.xhtml
x3-the-pattern-and-mission-of-jesus	Text/3 - The Pattern and Mission of Jesus.xhtml
x4-my-struggle-with-depression	Text/4 - My Struggle With Depression.xhtml
x5-people-i-failed-to-help	Text/5 - People I failed to Help.xhtml
x6-confrontation-with-demons	Text/6 - Confrontation with Demons.xhtml
x7-challenged-in-my-own-pulpit	Text/7 - Challenged in My Own Pulpit.xhtml
x8-beneath-the-surface	Text/8 - Beneath the Surface.xhtml
x9-lessons-from-an-expanding-ministry	Text/9 - Lessons From an Expanding Ministry.xhtml
part-1-fundamentals	Text/Part 1 - Fundamentals.xhtml
part-2-in-the-school-of-experience	Text/Part 2 - In the School of Experience.xhtml
part-3-seven-questions	Text/Part 3 - Seven Questions.xhtml
part-4-how-to-recognise-and-expel-demons	Text/Part 4 - How to Recognise and Expel Demons.xhtml
preface	Text/Preface.xhtml
copyright	Text/copyright.xhtml
titlepage	Text/titlepage.xhtml
